Published date,Positive_Count,Negative_Count,Neutral_Count,Total,Positive_Percentage,Negative_Percentage,Neutral_Percentage
2018-02-25,2,1,1,4,50,25,25
2018-02-26,2,1,5,8,25,12.5,62.5
2018-02-27,1,4,4,9,11.11111111,44.44444444,44.44444444
2018-02-28,5,1,3,9,55.55555556,11.11111111,33.33333333
2018-03-01,1,2,5,8,12.5,25,62.5
2018-03-02,3,3,4,10,30,30,40
2018-03-03,1,3,3,7,14.28571429,42.85714286,42.85714286
2018-03-04,1,1,4,6,16.66666667,16.66666667,66.66666667
2018-03-05,2,3,3,8,25,37.5,37.5
2018-03-06,2,6,2,10,20,60,20
2018-03-07,3,4,3,10,30,40,30
2018-03-08,2,3,5,10,20,30,50
2018-03-09,2,3,4,9,22.22222222,33.33333333,44.44444444
2018-03-10,0,1,1,2,0,50,50
2018-03-11,2,3,4,9,22.22222222,33.33333333,44.44444444
2018-03-12,0,5,5,10,0,50,50
2018-03-13,5,3,1,9,55.55555556,33.33333333,11.11111111
2018-03-14,1,2,6,9,11.11111111,22.22222222,66.66666667
2018-03-15,2,5,2,9,22.22222222,55.55555556,22.22222222
2018-03-16,5,1,4,10,50,10,40
2018-03-17,2,2,5,9,22.22222222,22.22222222,55.55555556
2018-03-18,2,2,4,8,25,25,50
2018-03-19,2,3,3,8,25,37.5,37.5
2018-03-20,3,4,3,10,30,40,30
2018-03-21,1,3,6,10,10,30,60
2018-03-22,1,1,5,7,14.28571429,14.28571429,71.42857143
2018-03-23,2,1,7,10,20,10,70
2018-03-24,2,0,0,2,100,0,0
2018-03-25,1,1,4,6,16.66666667,16.66666667,66.66666667
2018-03-26,4,1,3,8,50,12.5,37.5
2018-03-27,3,3,4,10,30,30,40
2018-03-28,1,2,6,9,11.11111111,22.22222222,66.66666667
2018-03-29,3,4,2,9,33.33333333,44.44444444,22.22222222
2018-03-30,2,2,1,5,40,40,20
2018-03-31,2,0,1,3,66.66666667,0,33.33333333
2018-04-01,2,1,2,5,40,20,40
2018-04-02,4,1,5,10,40,10,50
2018-04-03,1,3,6,10,10,30,60
2018-04-04,2,1,6,9,22.22222222,11.11111111,66.66666667
2018-04-05,1,2,6,9,11.11111111,22.22222222,66.66666667
2018-04-06,4,4,2,10,40,40,20
2018-04-07,3,0,2,5,60,0,40
2018-04-08,3,0,3,6,50,0,50
2018-04-09,2,1,5,8,25,12.5,62.5
2018-04-10,1,1,7,9,11.11111111,11.11111111,77.77777778
2018-04-11,1,3,5,9,11.11111111,33.33333333,55.55555556
2018-04-12,4,3,2,9,44.44444444,33.33333333,22.22222222
2018-04-13,4,2,3,9,44.44444444,22.22222222,33.33333333
2018-04-14,3,1,1,5,60,20,20
2018-04-15,1,1,2,4,25,25,50
2018-04-16,2,2,5,9,22.22222222,22.22222222,55.55555556
2018-04-17,3,0,5,8,37.5,0,62.5
2018-04-18,4,2,3,9,44.44444444,22.22222222,33.33333333
2018-04-19,3,5,2,10,30,50,20
2018-04-20,3,3,4,10,30,30,40
2018-04-21,2,1,4,7,28.57142857,14.28571429,57.14285714
2018-04-22,1,0,4,5,20,0,80
2018-04-23,1,1,7,9,11.11111111,11.11111111,77.77777778
2018-04-24,1,7,2,10,10,70,20
2018-04-25,3,1,4,8,37.5,12.5,50
2018-04-26,2,2,6,10,20,20,60
2018-04-27,5,0,4,9,55.55555556,0,44.44444444
2018-04-28,2,0,4,6,33.33333333,0,66.66666667
2018-04-29,3,1,4,8,37.5,12.5,50
2018-04-30,2,2,5,9,22.22222222,22.22222222,55.55555556
2018-05-01,2,1,5,8,25,12.5,62.5
2018-05-02,1,0,7,8,12.5,0,87.5
2018-05-03,0,3,7,10,0,30,70
2018-05-04,5,2,2,9,55.55555556,22.22222222,22.22222222
2018-05-05,5,1,4,10,50,10,40
2018-05-06,0,1,1,2,0,50,50
2018-05-07,2,3,5,10,20,30,50
2018-05-08,3,0,6,9,33.33333333,0,66.66666667
2018-05-09,2,2,3,7,28.57142857,28.57142857,42.85714286
2018-05-10,1,1,7,9,11.11111111,11.11111111,77.77777778
2018-05-11,1,3,5,9,11.11111111,33.33333333,55.55555556
2018-05-12,2,2,4,8,25,25,50
2018-05-13,2,2,3,7,28.57142857,28.57142857,42.85714286
2018-05-14,1,3,6,10,10,30,60
2018-05-15,1,3,5,9,11.11111111,33.33333333,55.55555556
2018-05-16,1,5,4,10,10,50,40
2018-05-17,3,1,6,10,30,10,60
2018-05-18,2,4,4,10,20,40,40
2018-05-19,1,0,3,4,25,0,75
2018-05-20,4,1,5,10,40,10,50
2018-05-21,5,1,3,9,55.55555556,11.11111111,33.33333333
2018-05-22,5,1,2,8,62.5,12.5,25
2018-05-23,4,3,3,10,40,30,30
2018-05-24,0,1,6,7,0,14.28571429,85.71428571
2018-05-25,5,2,3,10,50,20,30
2018-05-26,3,2,0,5,60,40,0
2018-05-27,0,1,6,7,0,14.28571429,85.71428571
2018-05-28,1,5,4,10,10,50,40
2018-05-29,2,2,4,8,25,25,50
2018-05-30,1,5,3,9,11.11111111,55.55555556,33.33333333
2018-05-31,3,1,6,10,30,10,60
2018-06-01,3,0,5,8,37.5,0,62.5
2018-06-02,2,0,3,5,40,0,60
2018-06-03,1,1,4,6,16.66666667,16.66666667,66.66666667
2018-06-04,3,0,6,9,33.33333333,0,66.66666667
2018-06-05,3,2,4,9,33.33333333,22.22222222,44.44444444
2018-06-06,4,0,5,9,44.44444444,0,55.55555556
2018-06-07,2,3,4,9,22.22222222,33.33333333,44.44444444
2018-06-08,2,1,5,8,25,12.5,62.5
2018-06-09,1,0,5,6,16.66666667,0,83.33333333
2018-06-10,4,0,3,7,57.14285714,0,42.85714286
2018-06-11,4,2,3,9,44.44444444,22.22222222,33.33333333
2018-06-12,5,2,3,10,50,20,30
2018-06-13,5,2,3,10,50,20,30
2018-06-14,4,1,5,10,40,10,50
2018-06-15,3,2,5,10,30,20,50
2018-06-16,2,0,5,7,28.57142857,0,71.42857143
2018-06-17,4,0,4,8,50,0,50
2018-06-18,4,1,5,10,40,10,50
2018-06-19,4,2,3,9,44.44444444,22.22222222,33.33333333
2018-06-20,1,3,5,9,11.11111111,33.33333333,55.55555556
2018-06-21,1,2,6,9,11.11111111,22.22222222,66.66666667
2018-06-22,1,3,5,9,11.11111111,33.33333333,55.55555556
2018-06-23,1,2,2,5,20,40,40
2018-06-24,1,3,2,6,16.66666667,50,33.33333333
2018-06-25,1,2,5,8,12.5,25,62.5
2018-06-26,4,2,2,8,50,25,25
2018-06-27,1,3,6,10,10,30,60
2018-06-28,4,0,4,8,50,0,50
2018-06-29,3,1,5,9,33.33333333,11.11111111,55.55555556
2018-06-30,0,1,4,5,0,20,80
2018-07-01,7,0,3,10,70,0,30
2018-07-02,2,2,3,7,28.57142857,28.57142857,42.85714286
2018-07-03,1,2,5,8,12.5,25,62.5
2018-07-04,1,3,2,6,16.66666667,50,33.33333333
2018-07-05,5,2,1,8,62.5,25,12.5
2018-07-06,3,3,2,8,37.5,37.5,25
2018-07-07,2,2,3,7,28.57142857,28.57142857,42.85714286
2018-07-08,2,2,1,5,40,40,20
2018-07-09,3,2,5,10,30,20,50
2018-07-10,4,2,3,9,44.44444444,22.22222222,33.33333333
2018-07-11,3,3,3,9,33.33333333,33.33333333,33.33333333
2018-07-12,3,1,5,9,33.33333333,11.11111111,55.55555556
2018-07-13,4,0,6,10,40,0,60
2018-07-14,3,0,3,6,50,0,50
2018-07-15,1,3,6,10,10,30,60
2018-07-16,6,0,1,7,85.71428571,0,14.28571429
2018-07-17,3,3,4,10,30,30,40
2018-07-18,4,3,3,10,40,30,30
2018-07-19,3,2,5,10,30,20,50
2018-07-20,3,0,4,7,42.85714286,0,57.14285714
2018-07-21,3,2,3,8,37.5,25,37.5
2018-07-22,2,1,5,8,25,12.5,62.5
2018-07-23,4,0,4,8,50,0,50
2018-07-24,4,0,6,10,40,0,60
2018-07-25,2,2,4,8,25,25,50
2018-07-26,1,6,3,10,10,60,30
2018-07-27,0,4,3,7,0,57.14285714,42.85714286
2018-07-28,1,1,0,2,50,50,0
2018-07-29,2,1,1,4,50,25,25
2018-07-30,2,1,6,9,22.22222222,11.11111111,66.66666667
2018-07-31,4,2,1,7,57.14285714,28.57142857,14.28571429
2018-08-01,4,2,3,9,44.44444444,22.22222222,33.33333333
2018-08-02,6,2,2,10,60,20,20
2018-08-03,2,1,6,9,22.22222222,11.11111111,66.66666667
2018-08-04,2,0,4,6,33.33333333,0,66.66666667
2018-08-05,4,1,1,6,66.66666667,16.66666667,16.66666667
2018-08-06,1,2,6,9,11.11111111,22.22222222,66.66666667
2018-08-07,3,4,3,10,30,40,30
2018-08-08,3,1,5,9,33.33333333,11.11111111,55.55555556
2018-08-09,6,4,0,10,60,40,0
2018-08-10,3,2,5,10,30,20,50
2018-08-11,2,1,6,9,22.22222222,11.11111111,66.66666667
2018-08-12,4,0,3,7,57.14285714,0,42.85714286
2018-08-13,2,2,6,10,20,20,60
2018-08-14,1,4,5,10,10,40,50
2018-08-15,6,2,2,10,60,20,20
2018-08-16,2,0,6,8,25,0,75
2018-08-17,2,1,4,7,28.57142857,14.28571429,57.14285714
2018-08-18,2,1,4,7,28.57142857,14.28571429,57.14285714
2018-08-19,4,0,1,5,80,0,20
2018-08-20,4,5,1,10,40,50,10
2018-08-21,2,3,3,8,25,37.5,37.5
2018-08-22,2,1,7,10,20,10,70
2018-08-23,2,3,5,10,20,30,50
2018-08-24,1,1,3,5,20,20,60
2018-08-25,1,1,3,5,20,20,60
2018-08-26,2,2,4,8,25,25,50
2018-08-27,1,2,6,9,11.11111111,22.22222222,66.66666667
2018-08-28,1,2,5,8,12.5,25,62.5
2018-08-29,3,0,5,8,37.5,0,62.5
2018-08-30,2,1,4,7,28.57142857,14.28571429,57.14285714
2018-08-31,0,2,6,8,0,25,75
2018-09-01,2,0,3,5,40,0,60
2018-09-02,2,2,5,9,22.22222222,22.22222222,55.55555556
2018-09-03,4,2,2,8,50,25,25
2018-09-04,1,2,6,9,11.11111111,22.22222222,66.66666667
2018-09-05,2,2,5,9,22.22222222,22.22222222,55.55555556
2018-09-06,1,3,6,10,10,30,60
2018-09-07,2,2,4,8,25,25,50
2018-09-08,4,1,4,9,44.44444444,11.11111111,44.44444444
2018-09-09,0,2,2,4,0,50,50
2018-09-10,5,1,4,10,50,10,40
2018-09-11,2,3,4,9,22.22222222,33.33333333,44.44444444
2018-09-12,4,0,5,9,44.44444444,0,55.55555556
2018-09-13,2,3,5,10,20,30,50
2018-09-14,5,1,4,10,50,10,40
2018-09-15,1,0,1,2,50,0,50
2018-09-16,2,1,6,9,22.22222222,11.11111111,66.66666667
2018-09-17,1,1,5,7,14.28571429,14.28571429,71.42857143
2018-09-18,3,2,4,9,33.33333333,22.22222222,44.44444444
2018-09-19,2,3,5,10,20,30,50
2018-09-20,4,1,4,9,44.44444444,11.11111111,44.44444444
2018-09-21,2,4,4,10,20,40,40
2018-09-22,4,0,3,7,57.14285714,0,42.85714286
2018-09-23,2,2,3,7,28.57142857,28.57142857,42.85714286
2018-09-24,4,1,5,10,40,10,50
2018-09-25,4,1,4,9,44.44444444,11.11111111,44.44444444
2018-09-26,3,1,5,9,33.33333333,11.11111111,55.55555556
2018-09-27,1,2,6,9,11.11111111,22.22222222,66.66666667
2018-09-28,3,1,4,8,37.5,12.5,50
2018-09-29,2,0,3,5,40,0,60
2018-09-30,4,1,1,6,66.66666667,16.66666667,16.66666667
2018-10-01,2,1,5,8,25,12.5,62.5
2018-10-02,2,1,5,8,25,12.5,62.5
2018-10-03,3,2,4,9,33.33333333,22.22222222,44.44444444
2018-10-04,1,1,8,10,10,10,80
2018-10-05,3,3,3,9,33.33333333,33.33333333,33.33333333
2018-10-06,3,1,1,5,60,20,20
2018-10-07,1,2,1,4,25,50,25
2018-10-08,2,1,3,6,33.33333333,16.66666667,50
2018-10-09,4,0,6,10,40,0,60
2018-10-10,4,3,2,9,44.44444444,33.33333333,22.22222222
2018-10-11,2,3,3,8,25,37.5,37.5
2018-10-12,2,3,5,10,20,30,50
2018-10-13,1,1,4,6,16.66666667,16.66666667,66.66666667
2018-10-14,3,2,0,5,60,40,0
2018-10-15,2,2,4,8,25,25,50
2018-10-16,0,5,3,8,0,62.5,37.5
2018-10-17,1,1,3,5,20,20,60
2018-10-18,4,2,3,9,44.44444444,22.22222222,33.33333333
2018-10-19,3,3,4,10,30,30,40
2018-10-20,0,0,3,3,0,0,100
2018-10-21,0,1,1,2,0,50,50
2018-10-22,2,1,6,9,22.22222222,11.11111111,66.66666667
2018-10-23,1,2,6,9,11.11111111,22.22222222,66.66666667
2018-10-24,1,2,5,8,12.5,25,62.5
2018-10-25,0,4,6,10,0,40,60
2018-10-26,3,0,6,9,33.33333333,0,66.66666667
2018-10-27,4,1,1,6,66.66666667,16.66666667,16.66666667
2018-10-28,1,0,7,8,12.5,0,87.5
2018-10-29,2,2,4,8,25,25,50
2018-10-30,3,2,5,10,30,20,50
2018-10-31,3,4,3,10,30,40,30
2018-11-01,3,1,5,9,33.33333333,11.11111111,55.55555556
2018-11-02,1,1,7,9,11.11111111,11.11111111,77.77777778
2018-11-03,1,1,4,6,16.66666667,16.66666667,66.66666667
2018-11-04,1,1,3,5,20,20,60
2018-11-05,3,2,5,10,30,20,50
2018-11-06,2,4,3,9,22.22222222,44.44444444,33.33333333
2018-11-07,2,3,5,10,20,30,50
2018-11-08,5,2,1,8,62.5,25,12.5
2018-11-09,4,3,2,9,44.44444444,33.33333333,22.22222222
2018-11-10,0,2,1,3,0,66.66666667,33.33333333
2018-11-11,0,2,1,3,0,66.66666667,33.33333333
2018-11-12,2,3,3,8,25,37.5,37.5
2018-11-13,0,4,5,9,0,44.44444444,55.55555556
2018-11-14,1,4,5,10,10,40,50
2018-11-15,2,6,2,10,20,60,20
2018-11-16,3,6,0,9,33.33333333,66.66666667,0
2018-11-17,1,3,4,8,12.5,37.5,50
2018-11-18,1,2,1,4,25,50,25
2018-11-19,2,3,5,10,20,30,50
2018-11-20,3,2,4,9,33.33333333,22.22222222,44.44444444
2018-11-21,3,3,4,10,30,30,40
2018-11-22,1,1,4,6,16.66666667,16.66666667,66.66666667
2018-11-23,3,3,3,9,33.33333333,33.33333333,33.33333333
2018-11-24,3,1,5,9,33.33333333,11.11111111,55.55555556
2018-11-25,2,3,3,8,25,37.5,37.5
2018-11-26,2,6,2,10,20,60,20
2018-11-27,5,4,1,10,50,40,10
2018-11-28,4,2,4,10,40,20,40
2018-11-29,7,2,1,10,70,20,10
2018-11-30,2,1,7,10,20,10,70
2018-12-01,2,1,5,8,25,12.5,62.5
2018-12-02,0,1,3,4,0,25,75
2018-12-03,3,2,4,9,33.33333333,22.22222222,44.44444444
2018-12-04,2,4,2,8,25,50,25
2018-12-05,2,2,3,7,28.57142857,28.57142857,42.85714286
2018-12-06,1,4,5,10,10,40,50
2018-12-07,0,1,5,6,0,16.66666667,83.33333333
2018-12-08,1,1,3,5,20,20,60
2018-12-09,1,1,0,2,50,50,0
2018-12-10,6,4,0,10,60,40,0
2018-12-11,3,1,5,9,33.33333333,11.11111111,55.55555556
2018-12-12,2,1,5,8,25,12.5,62.5
2018-12-13,1,2,5,8,12.5,25,62.5
2018-12-14,1,2,6,9,11.11111111,22.22222222,66.66666667
2018-12-15,3,1,1,5,60,20,20
2018-12-16,1,3,3,7,14.28571429,42.85714286,42.85714286
2018-12-17,2,0,6,8,25,0,75
2018-12-18,1,1,8,10,10,10,80
2018-12-19,2,2,5,9,22.22222222,22.22222222,55.55555556
2018-12-20,1,2,5,8,12.5,25,62.5
2018-12-21,0,3,7,10,0,30,70
2018-12-22,0,0,1,1,0,0,100
2018-12-23,2,1,2,5,40,20,40
2018-12-24,3,3,2,8,37.5,37.5,25
2018-12-25,2,0,4,6,33.33333333,0,66.66666667
2018-12-26,2,1,4,7,28.57142857,14.28571429,57.14285714
2018-12-27,0,4,4,8,0,50,50
2018-12-28,2,4,2,8,25,50,25
2018-12-29,1,2,5,8,12.5,25,62.5
2018-12-30,1,0,3,4,25,0,75
2018-12-31,2,1,5,8,25,12.5,62.5
2019-01-01,1,4,1,6,16.66666667,66.66666667,16.66666667
2019-01-02,3,2,4,9,33.33333333,22.22222222,44.44444444
2019-01-03,5,2,2,9,55.55555556,22.22222222,22.22222222
2019-01-04,2,2,5,9,22.22222222,22.22222222,55.55555556
2019-01-05,2,5,3,10,20,50,30
2019-01-06,2,4,3,9,22.22222222,44.44444444,33.33333333
2019-01-07,2,0,7,9,22.22222222,0,77.77777778
2019-01-08,0,2,6,8,0,25,75
2019-01-09,2,2,4,8,25,25,50
2019-01-10,0,4,4,8,0,50,50
2019-01-11,4,3,2,9,44.44444444,33.33333333,22.22222222
2019-01-12,3,0,4,7,42.85714286,0,57.14285714
2019-01-13,3,0,0,3,100,0,0
2019-01-14,2,2,6,10,20,20,60
2019-01-15,2,4,4,10,20,40,40
2019-01-16,0,4,3,7,0,57.14285714,42.85714286
2019-01-17,3,1,3,7,42.85714286,14.28571429,42.85714286
2019-01-18,0,2,6,8,0,25,75
2019-01-19,2,2,3,7,28.57142857,28.57142857,42.85714286
2019-01-20,0,2,3,5,0,40,60
2019-01-21,3,2,4,9,33.33333333,22.22222222,44.44444444
2019-01-22,2,1,1,4,50,25,25
2019-01-23,3,0,6,9,33.33333333,0,66.66666667
2019-01-24,3,3,1,7,42.85714286,42.85714286,14.28571429
2019-01-25,3,2,2,7,42.85714286,28.57142857,28.57142857
2019-01-26,2,1,3,6,33.33333333,16.66666667,50
2019-01-27,4,0,0,4,100,0,0
2019-01-28,1,2,5,8,12.5,25,62.5
2019-01-29,3,4,3,10,30,40,30
2019-01-30,3,1,3,7,42.85714286,14.28571429,42.85714286
2019-01-31,3,2,3,8,37.5,25,37.5
2019-02-01,2,1,5,8,25,12.5,62.5
2019-02-02,1,0,5,6,16.66666667,0,83.33333333
2019-02-03,0,4,2,6,0,66.66666667,33.33333333
2019-02-04,1,1,5,7,14.28571429,14.28571429,71.42857143
2019-02-05,3,4,1,8,37.5,50,12.5
2019-02-06,2,1,5,8,25,12.5,62.5
2019-02-07,5,0,2,7,71.42857143,0,28.57142857
2019-02-08,3,3,4,10,30,30,40
2019-02-09,2,3,3,8,25,37.5,37.5
2019-02-10,3,1,1,5,60,20,20
2019-02-11,2,4,3,9,22.22222222,44.44444444,33.33333333
2019-02-12,3,3,3,9,33.33333333,33.33333333,33.33333333
2019-02-13,2,2,3,7,28.57142857,28.57142857,42.85714286
2019-02-14,3,3,4,10,30,30,40
2019-02-15,2,3,3,8,25,37.5,37.5
2019-02-16,2,1,4,7,28.57142857,14.28571429,57.14285714
2019-02-17,3,0,1,4,75,0,25
2019-02-18,5,0,4,9,55.55555556,0,44.44444444
2019-02-19,2,0,7,9,22.22222222,0,77.77777778
2019-02-20,2,2,3,7,28.57142857,28.57142857,42.85714286
2019-02-21,4,0,4,8,50,0,50
2019-02-22,4,1,3,8,50,12.5,37.5
2019-02-23,1,0,6,7,14.28571429,0,85.71428571
2019-02-24,4,2,1,7,57.14285714,28.57142857,14.28571429
2019-02-25,3,2,4,9,33.33333333,22.22222222,44.44444444
2019-02-26,3,0,5,8,37.5,0,62.5
2019-02-27,1,2,4,7,14.28571429,28.57142857,57.14285714
2019-02-28,2,4,3,9,22.22222222,44.44444444,33.33333333
2019-03-01,0,1,7,8,0,12.5,87.5
2019-03-02,1,1,1,3,33.33333333,33.33333333,33.33333333
2019-03-03,1,1,3,5,20,20,60
2019-03-04,4,1,5,10,40,10,50
2019-03-05,3,3,3,9,33.33333333,33.33333333,33.33333333
2019-03-06,4,1,3,8,50,12.5,37.5
2019-03-07,1,0,8,9,11.11111111,0,88.88888889
2019-03-08,2,6,1,9,22.22222222,66.66666667,11.11111111
2019-03-09,1,2,1,4,25,50,25
2019-03-10,2,3,1,6,33.33333333,50,16.66666667
2019-03-11,4,2,3,9,44.44444444,22.22222222,33.33333333
2019-03-12,5,1,2,8,62.5,12.5,25
2019-03-13,2,2,5,9,22.22222222,22.22222222,55.55555556
2019-03-14,1,4,3,8,12.5,50,37.5
2019-03-15,3,1,5,9,33.33333333,11.11111111,55.55555556
2019-03-16,3,1,4,8,37.5,12.5,50
2019-03-17,0,2,2,4,0,50,50
2019-03-18,4,2,4,10,40,20,40
2019-03-19,4,0,3,7,57.14285714,0,42.85714286
2019-03-20,2,2,3,7,28.57142857,28.57142857,42.85714286
2019-03-21,4,1,2,7,57.14285714,14.28571429,28.57142857
2019-03-22,1,3,5,9,11.11111111,33.33333333,55.55555556
2019-03-23,1,0,6,7,14.28571429,0,85.71428571
2019-03-24,2,1,3,6,33.33333333,16.66666667,50
2019-03-25,1,3,6,10,10,30,60
2019-03-26,3,3,4,10,30,30,40
2019-03-27,4,1,3,8,50,12.5,37.5
2019-03-28,2,1,6,9,22.22222222,11.11111111,66.66666667
2019-03-29,3,1,5,9,33.33333333,11.11111111,55.55555556
2019-03-30,1,2,2,5,20,40,40
2019-03-31,1,0,3,4,25,0,75
2019-04-01,3,4,1,8,37.5,50,12.5
2019-04-02,4,0,6,10,40,0,60
2019-04-03,1,1,7,9,11.11111111,11.11111111,77.77777778
2019-04-04,1,3,5,9,11.11111111,33.33333333,55.55555556
2019-04-05,3,2,3,8,37.5,25,37.5
2019-04-06,0,1,4,5,0,20,80
2019-04-07,2,2,4,8,25,25,50
2019-04-08,1,2,6,9,11.11111111,22.22222222,66.66666667
2019-04-09,2,2,4,8,25,25,50
2019-04-10,3,1,1,5,60,20,20
2019-04-11,1,2,5,8,12.5,25,62.5
2019-04-12,1,3,2,6,16.66666667,50,33.33333333
2019-04-13,1,1,1,3,33.33333333,33.33333333,33.33333333
2019-04-14,1,0,3,4,25,0,75
2019-04-15,3,1,6,10,30,10,60
2019-04-16,3,2,4,9,33.33333333,22.22222222,44.44444444
2019-04-17,3,1,4,8,37.5,12.5,50
2019-04-18,2,2,5,9,22.22222222,22.22222222,55.55555556
2019-04-19,1,3,5,9,11.11111111,33.33333333,55.55555556
2019-04-20,0,2,1,3,0,66.66666667,33.33333333
2019-04-21,3,2,3,8,37.5,25,37.5
2019-04-22,3,2,3,8,37.5,25,37.5
2019-04-23,4,3,3,10,40,30,30
2019-04-24,2,1,7,10,20,10,70
2019-04-25,2,1,5,8,25,12.5,62.5
2019-04-26,2,1,7,10,20,10,70
2019-04-27,1,1,3,5,20,20,60
2019-04-28,0,3,6,9,0,33.33333333,66.66666667
2019-04-29,1,2,5,8,12.5,25,62.5
2019-04-30,2,1,5,8,25,12.5,62.5
2019-05-01,2,4,3,9,22.22222222,44.44444444,33.33333333
2019-05-02,3,1,5,9,33.33333333,11.11111111,55.55555556
2019-05-03,1,2,6,9,11.11111111,22.22222222,66.66666667
2019-05-04,1,2,1,4,25,50,25
2019-05-05,3,3,1,7,42.85714286,42.85714286,14.28571429
2019-05-06,0,3,7,10,0,30,70
2019-05-07,1,5,4,10,10,50,40
2019-05-08,5,1,0,6,83.33333333,16.66666667,0
2019-05-09,1,4,4,9,11.11111111,44.44444444,44.44444444
2019-05-10,4,0,4,8,50,0,50
2019-05-11,2,0,6,8,25,0,75
2019-05-12,0,2,2,4,0,50,50
2019-05-13,1,2,5,8,12.5,25,62.5
2019-05-14,3,0,6,9,33.33333333,0,66.66666667
2019-05-15,4,2,2,8,50,25,25
2019-05-16,2,1,6,9,22.22222222,11.11111111,66.66666667
2019-05-17,1,3,4,8,12.5,37.5,50
2019-05-18,1,1,4,6,16.66666667,16.66666667,66.66666667
2019-05-19,0,2,5,7,0,28.57142857,71.42857143
2019-05-20,1,5,3,9,11.11111111,55.55555556,33.33333333
2019-05-21,0,0,6,6,0,0,100
2019-05-22,2,1,7,10,20,10,70
2019-05-23,3,1,5,9,33.33333333,11.11111111,55.55555556
2019-05-24,3,1,6,10,30,10,60
2019-05-25,2,1,2,5,40,20,40
2019-05-26,0,2,3,5,0,40,60
2019-05-27,1,1,5,7,14.28571429,14.28571429,71.42857143
2019-05-28,1,1,6,8,12.5,12.5,75
2019-05-29,1,1,5,7,14.28571429,14.28571429,71.42857143
2019-05-30,2,0,7,9,22.22222222,0,77.77777778
2019-05-31,2,3,4,9,22.22222222,33.33333333,44.44444444
2019-06-01,0,0,2,2,0,0,100
2019-06-02,1,1,4,6,16.66666667,16.66666667,66.66666667
2019-06-03,2,2,6,10,20,20,60
2019-06-04,1,2,5,8,12.5,25,62.5
2019-06-05,2,2,6,10,20,20,60
2019-06-06,1,4,2,7,14.28571429,57.14285714,28.57142857
2019-06-07,2,5,3,10,20,50,30
2019-06-08,0,1,3,4,0,25,75
2019-06-09,2,2,4,8,25,25,50
2019-06-10,3,2,4,9,33.33333333,22.22222222,44.44444444
2019-06-11,2,2,5,9,22.22222222,22.22222222,55.55555556
2019-06-12,2,3,2,7,28.57142857,42.85714286,28.57142857
2019-06-13,2,2,5,9,22.22222222,22.22222222,55.55555556
2019-06-14,2,1,5,8,25,12.5,62.5
2019-06-15,0,1,1,2,0,50,50
2019-06-16,3,0,3,6,50,0,50
2019-06-17,2,1,5,8,25,12.5,62.5
2019-06-18,1,3,6,10,10,30,60
2019-06-19,3,1,4,8,37.5,12.5,50
2019-06-20,3,0,5,8,37.5,0,62.5
2019-06-21,3,1,4,8,37.5,12.5,50
2019-06-22,0,0,3,3,0,0,100
2019-06-23,1,3,3,7,14.28571429,42.85714286,42.85714286
2019-06-24,3,1,4,8,37.5,12.5,50
2019-06-25,3,1,5,9,33.33333333,11.11111111,55.55555556
2019-06-26,0,4,5,9,0,44.44444444,55.55555556
2019-06-27,4,0,5,9,44.44444444,0,55.55555556
2019-06-28,2,1,6,9,22.22222222,11.11111111,66.66666667
2019-06-29,3,1,4,8,37.5,12.5,50
2019-06-30,3,3,2,8,37.5,37.5,25
2019-07-01,2,1,5,8,25,12.5,62.5
2019-07-02,3,0,4,7,42.85714286,0,57.14285714
2019-07-03,1,3,0,4,25,75,0
2019-07-04,2,3,4,9,22.22222222,33.33333333,44.44444444
2019-07-05,5,1,4,10,50,10,40
2019-07-06,0,0,3,3,0,0,100
2019-07-07,3,2,4,9,33.33333333,22.22222222,44.44444444
2019-07-08,1,1,7,9,11.11111111,11.11111111,77.77777778
2019-07-09,2,2,6,10,20,20,60
2019-07-10,4,1,5,10,40,10,50
2019-07-11,3,2,4,9,33.33333333,22.22222222,44.44444444
2019-07-12,2,3,3,8,25,37.5,37.5
2019-07-13,1,1,4,6,16.66666667,16.66666667,66.66666667
2019-07-14,1,1,2,4,25,25,50
2019-07-15,2,3,3,8,25,37.5,37.5
2019-07-16,3,3,4,10,30,30,40
2019-07-17,4,1,3,8,50,12.5,37.5
2019-07-18,2,1,4,7,28.57142857,14.28571429,57.14285714
2019-07-19,2,0,6,8,25,0,75
2019-07-20,1,1,4,6,16.66666667,16.66666667,66.66666667
2019-07-21,0,2,2,4,0,50,50
2019-07-22,0,3,3,6,0,50,50
2019-07-23,2,2,3,7,28.57142857,28.57142857,42.85714286
2019-07-24,1,2,3,6,16.66666667,33.33333333,50
2019-07-25,4,0,2,6,66.66666667,0,33.33333333
2019-07-26,1,3,3,7,14.28571429,42.85714286,42.85714286
2019-07-27,1,0,1,2,50,0,50
2019-07-28,2,3,4,9,22.22222222,33.33333333,44.44444444
2019-07-29,2,2,6,10,20,20,60
2019-07-30,1,6,1,8,12.5,75,12.5
2019-07-31,1,2,5,8,12.5,25,62.5
2019-08-01,1,3,5,9,11.11111111,33.33333333,55.55555556
2019-08-02,4,0,4,8,50,0,50
2019-08-03,0,0,3,3,0,0,100
2019-08-04,0,0,5,5,0,0,100
2019-08-05,1,3,5,9,11.11111111,33.33333333,55.55555556
2019-08-06,4,1,4,9,44.44444444,11.11111111,44.44444444
2019-08-07,5,2,2,9,55.55555556,22.22222222,22.22222222
2019-08-08,2,1,5,8,25,12.5,62.5
2019-08-09,2,1,6,9,22.22222222,11.11111111,66.66666667
2019-08-10,0,1,3,4,0,25,75
2019-08-11,0,2,2,4,0,50,50
2019-08-12,2,3,4,9,22.22222222,33.33333333,44.44444444
2019-08-13,5,0,2,7,71.42857143,0,28.57142857
2019-08-14,2,3,1,6,33.33333333,50,16.66666667
2019-08-15,2,3,5,10,20,30,50
2019-08-16,3,3,2,8,37.5,37.5,25
2019-08-18,1,1,2,4,25,25,50
2019-08-19,3,1,5,9,33.33333333,11.11111111,55.55555556
2019-08-20,5,1,2,8,62.5,12.5,25
2019-08-21,3,1,3,7,42.85714286,14.28571429,42.85714286
2019-08-22,3,3,3,9,33.33333333,33.33333333,33.33333333
2019-08-23,2,1,5,8,25,12.5,62.5
2019-08-24,2,1,4,7,28.57142857,14.28571429,57.14285714
2019-08-25,3,0,4,7,42.85714286,0,57.14285714
2019-08-26,2,2,4,8,25,25,50
2019-08-27,2,2,6,10,20,20,60
2019-08-28,2,2,6,10,20,20,60
2019-08-29,2,1,5,8,25,12.5,62.5
2019-08-30,4,1,2,7,57.14285714,14.28571429,28.57142857
2019-08-31,2,0,4,6,33.33333333,0,66.66666667
2019-09-01,1,2,1,4,25,50,25
2019-09-02,2,3,1,6,33.33333333,50,16.66666667
2019-09-03,5,0,3,8,62.5,0,37.5
2019-09-04,2,0,4,6,33.33333333,0,66.66666667
2019-09-05,6,0,1,7,85.71428571,0,14.28571429
2019-09-06,1,1,3,5,20,20,60
2019-09-07,1,0,2,3,33.33333333,0,66.66666667
2019-09-08,2,0,0,2,100,0,0
2019-09-09,2,4,2,8,25,50,25
2019-09-10,4,0,3,7,57.14285714,0,42.85714286
2019-09-11,1,1,4,6,16.66666667,16.66666667,66.66666667
2019-09-12,1,5,4,10,10,50,40
2019-09-13,0,0,6,6,0,0,100
2019-09-14,3,0,3,6,50,0,50
2019-09-15,1,1,3,5,20,20,60
2019-09-16,3,1,5,9,33.33333333,11.11111111,55.55555556
2019-09-17,1,0,7,8,12.5,0,87.5
2019-09-18,2,1,4,7,28.57142857,14.28571429,57.14285714
2019-09-19,3,2,5,10,30,20,50
2019-09-20,4,1,4,9,44.44444444,11.11111111,44.44444444
2019-09-21,2,0,6,8,25,0,75
2019-09-22,0,0,2,2,0,0,100
2019-09-23,2,3,4,9,22.22222222,33.33333333,44.44444444
2019-09-24,0,4,4,8,0,50,50
2019-09-25,4,0,5,9,44.44444444,0,55.55555556
2019-09-26,0,4,5,9,0,44.44444444,55.55555556
2019-09-27,2,3,1,6,33.33333333,50,16.66666667
2019-09-29,1,1,3,5,20,20,60
2019-09-30,3,1,6,10,30,10,60
2019-10-01,1,2,5,8,12.5,25,62.5
2019-10-02,4,4,2,10,40,40,20
2019-10-03,4,2,4,10,40,20,40
2019-10-04,2,2,4,8,25,25,50
2019-10-05,2,1,1,4,50,25,25
2019-10-06,1,0,3,4,25,0,75
2019-10-07,3,0,7,10,30,0,70
2019-10-08,3,3,3,9,33.33333333,33.33333333,33.33333333
2019-10-09,4,2,4,10,40,20,40
2019-10-10,3,2,4,9,33.33333333,22.22222222,44.44444444
2019-10-11,0,2,1,3,0,66.66666667,33.33333333
2019-10-12,2,2,1,5,40,40,20
2019-10-13,0,0,3,3,0,0,100
2019-10-14,4,1,3,8,50,12.5,37.5
2019-10-15,1,4,5,10,10,40,50
2019-10-16,2,1,4,7,28.57142857,14.28571429,57.14285714
2019-10-17,4,2,3,9,44.44444444,22.22222222,33.33333333
2019-10-18,3,3,4,10,30,30,40
2019-10-19,5,2,0,7,71.42857143,28.57142857,0
2019-10-20,1,0,3,4,25,0,75
2019-10-21,3,2,4,9,33.33333333,22.22222222,44.44444444
2019-10-22,0,4,5,9,0,44.44444444,55.55555556
2019-10-23,2,2,3,7,28.57142857,28.57142857,42.85714286
2019-10-24,2,2,5,9,22.22222222,22.22222222,55.55555556
2019-10-25,2,2,5,9,22.22222222,22.22222222,55.55555556
2019-10-26,1,1,2,4,25,25,50
2019-10-27,1,2,2,5,20,40,40
2019-10-28,3,0,7,10,30,0,70
2019-10-29,3,2,3,8,37.5,25,37.5
2019-10-30,3,2,2,7,42.85714286,28.57142857,28.57142857
2019-10-31,4,2,3,9,44.44444444,22.22222222,33.33333333
2019-11-01,1,2,5,8,12.5,25,62.5
2019-11-02,2,2,2,6,33.33333333,33.33333333,33.33333333
2019-11-03,2,2,4,8,25,25,50
2019-11-04,3,2,4,9,33.33333333,22.22222222,44.44444444
2019-11-05,5,2,2,9,55.55555556,22.22222222,22.22222222
2019-11-06,4,0,5,9,44.44444444,0,55.55555556
2019-11-07,3,1,5,9,33.33333333,11.11111111,55.55555556
2019-11-08,2,3,3,8,25,37.5,37.5
2019-11-09,1,1,3,5,20,20,60
2019-11-10,2,0,6,8,25,0,75
2019-11-11,2,2,5,9,22.22222222,22.22222222,55.55555556
2019-11-12,5,1,1,7,71.42857143,14.28571429,14.28571429
2019-11-13,3,2,5,10,30,20,50
2019-11-14,3,1,6,10,30,10,60
2019-11-15,2,0,7,9,22.22222222,0,77.77777778
2019-11-16,1,0,0,1,100,0,0
2019-11-17,0,0,4,4,0,0,100
2019-11-18,3,4,1,8,37.5,50,12.5
2019-11-19,3,1,4,8,37.5,12.5,50
2019-11-20,4,0,5,9,44.44444444,0,55.55555556
2019-11-21,6,0,3,9,66.66666667,0,33.33333333
2019-11-22,0,3,4,7,0,42.85714286,57.14285714
2019-11-23,2,1,2,5,40,20,40
2019-11-24,1,1,2,4,25,25,50
2019-11-25,1,1,8,10,10,10,80
2019-11-26,1,3,5,9,11.11111111,33.33333333,55.55555556
2019-11-27,1,2,6,9,11.11111111,22.22222222,66.66666667
2019-11-28,1,2,5,8,12.5,25,62.5
2019-11-29,2,2,5,9,22.22222222,22.22222222,55.55555556
2019-11-30,1,1,4,6,16.66666667,16.66666667,66.66666667
2019-12-01,1,1,2,4,25,25,50
2019-12-02,2,0,6,8,25,0,75
2019-12-03,3,1,4,8,37.5,12.5,50
2019-12-04,2,4,3,9,22.22222222,44.44444444,33.33333333
2019-12-05,2,4,3,9,22.22222222,44.44444444,33.33333333
2019-12-06,0,2,5,7,0,28.57142857,71.42857143
2019-12-07,0,1,4,5,0,20,80
2019-12-08,0,0,2,2,0,0,100
2019-12-09,2,1,5,8,25,12.5,62.5
2019-12-10,4,1,3,8,50,12.5,37.5
2019-12-11,6,3,0,9,66.66666667,33.33333333,0
2019-12-12,3,2,5,10,30,20,50
2019-12-13,1,1,1,3,33.33333333,33.33333333,33.33333333
2019-12-14,1,0,2,3,33.33333333,0,66.66666667
2019-12-15,3,1,2,6,50,16.66666667,33.33333333
2019-12-16,1,1,8,10,10,10,80
2019-12-17,3,3,3,9,33.33333333,33.33333333,33.33333333
2019-12-18,2,1,2,5,40,20,40
2019-12-19,4,2,1,7,57.14285714,28.57142857,14.28571429
2019-12-20,3,4,3,10,30,40,30
2019-12-21,2,0,4,6,33.33333333,0,66.66666667
2019-12-22,1,3,0,4,25,75,0
2019-12-23,2,2,5,9,22.22222222,22.22222222,55.55555556
2019-12-24,5,0,4,9,55.55555556,0,44.44444444
2019-12-25,0,0,2,2,0,0,100
2019-12-26,2,1,1,4,50,25,25
2019-12-27,2,2,2,6,33.33333333,33.33333333,33.33333333
2019-12-28,2,0,2,4,50,0,50
2019-12-29,2,1,0,3,66.66666667,33.33333333,0
2019-12-30,3,1,2,6,50,16.66666667,33.33333333
2019-12-31,2,2,3,7,28.57142857,28.57142857,42.85714286
2020-01-01,0,2,0,2,0,100,0
2020-01-02,2,1,2,5,40,20,40
2020-01-03,2,0,3,5,40,0,60
2020-01-04,2,0,2,4,50,0,50
2020-01-05,1,0,1,2,50,0,50
2020-01-06,0,4,6,10,0,40,60
2020-01-07,0,2,3,5,0,40,60
2020-01-08,1,2,4,7,14.28571429,28.57142857,57.14285714
2020-01-09,3,1,5,9,33.33333333,11.11111111,55.55555556
2020-01-10,4,3,2,9,44.44444444,33.33333333,22.22222222
2020-01-11,1,0,4,5,20,0,80
2020-01-12,1,0,1,2,50,0,50
2020-01-13,5,1,1,7,71.42857143,14.28571429,14.28571429
2020-01-14,4,0,6,10,40,0,60
2020-01-15,3,2,5,10,30,20,50
2020-01-16,3,1,3,7,42.85714286,14.28571429,42.85714286
2020-01-17,0,2,6,8,0,25,75
2020-01-18,3,1,1,5,60,20,20
2020-01-19,0,2,1,3,0,66.66666667,33.33333333
2020-01-20,5,0,3,8,62.5,0,37.5
2020-01-21,5,0,4,9,55.55555556,0,44.44444444
2020-01-22,2,1,7,10,20,10,70
2020-01-23,3,3,3,9,33.33333333,33.33333333,33.33333333
2020-01-24,3,5,2,10,30,50,20
2020-01-25,3,1,3,7,42.85714286,14.28571429,42.85714286
2020-01-26,2,3,3,8,25,37.5,37.5
2020-01-27,1,5,4,10,10,50,40
2020-01-28,0,1,6,7,0,14.28571429,85.71428571
2020-01-29,5,1,3,9,55.55555556,11.11111111,33.33333333
2020-01-30,1,1,5,7,14.28571429,14.28571429,71.42857143
2020-01-31,6,3,0,9,66.66666667,33.33333333,0
2020-02-01,2,2,0,4,50,50,0
2020-02-02,2,0,4,6,33.33333333,0,66.66666667
2020-02-03,4,1,3,8,50,12.5,37.5
2020-02-04,5,0,2,7,71.42857143,0,28.57142857
2020-02-05,3,1,5,9,33.33333333,11.11111111,55.55555556
2020-02-06,4,3,2,9,44.44444444,33.33333333,22.22222222
2020-02-07,1,1,5,7,14.28571429,14.28571429,71.42857143
2020-02-08,0,2,0,2,0,100,0
2020-02-09,1,0,3,4,25,0,75
2020-02-10,2,3,2,7,28.57142857,42.85714286,28.57142857
2020-02-11,5,3,1,9,55.55555556,33.33333333,11.11111111
2020-02-12,3,1,4,8,37.5,12.5,50
2020-02-13,1,6,3,10,10,60,30
2020-02-14,2,1,2,5,40,20,40
2020-02-16,3,3,1,7,42.85714286,42.85714286,14.28571429
2020-02-17,3,1,6,10,30,10,60
2020-02-18,1,1,6,8,12.5,12.5,75
2020-02-19,4,0,5,9,44.44444444,0,55.55555556
2020-02-20,2,2,5,9,22.22222222,22.22222222,55.55555556
2020-02-21,2,4,2,8,25,50,25
2020-02-22,2,1,1,4,50,25,25
2020-02-23,2,1,4,7,28.57142857,14.28571429,57.14285714
2020-02-24,2,2,4,8,25,25,50
2020-02-25,2,0,6,8,25,0,75
2020-02-26,3,3,2,8,37.5,37.5,25
2020-02-27,2,2,4,8,25,25,50
2020-02-28,1,3,5,9,11.11111111,33.33333333,55.55555556
2020-02-29,1,2,4,7,14.28571429,28.57142857,57.14285714
2020-03-01,0,2,2,4,0,50,50
2020-03-02,0,4,1,5,0,80,20
2020-03-03,1,3,4,8,12.5,37.5,50
2020-03-04,4,1,2,7,57.14285714,14.28571429,28.57142857
2020-03-05,5,1,2,8,62.5,12.5,25
2020-03-06,1,3,4,8,12.5,37.5,50
2020-03-07,1,0,2,3,33.33333333,0,66.66666667
2020-03-08,1,2,5,8,12.5,25,62.5
2020-03-09,2,2,3,7,28.57142857,28.57142857,42.85714286
2020-03-10,2,3,2,7,28.57142857,42.85714286,28.57142857
2020-03-11,1,2,0,3,33.33333333,66.66666667,0
2020-03-12,3,3,2,8,37.5,37.5,25
2020-03-13,0,3,3,6,0,50,50
2020-03-14,2,2,2,6,33.33333333,33.33333333,33.33333333
2020-03-15,3,3,0,6,50,50,0
2020-03-16,2,2,4,8,25,25,50
2020-03-17,3,3,2,8,37.5,37.5,25
2020-03-18,2,1,2,5,40,20,40
2020-03-19,2,0,5,7,28.57142857,0,71.42857143
2020-03-20,4,1,4,9,44.44444444,11.11111111,44.44444444
2020-03-21,1,1,2,4,25,25,50
2020-03-22,2,1,2,5,40,20,40
2020-03-23,2,1,3,6,33.33333333,16.66666667,50
2020-03-24,3,3,3,9,33.33333333,33.33333333,33.33333333
2020-03-25,4,0,3,7,57.14285714,0,42.85714286
2020-03-26,1,5,3,9,11.11111111,55.55555556,33.33333333
2020-03-27,4,1,3,8,50,12.5,37.5
2020-03-28,0,1,2,3,0,33.33333333,66.66666667
2020-03-29,1,1,2,4,25,25,50
2020-03-30,2,1,4,7,28.57142857,14.28571429,57.14285714
2020-03-31,0,3,3,6,0,50,50
2020-04-01,2,2,3,7,28.57142857,28.57142857,42.85714286
2020-04-02,4,2,2,8,50,25,25
2020-04-03,1,2,6,9,11.11111111,22.22222222,66.66666667
2020-04-04,1,2,3,6,16.66666667,33.33333333,50
2020-04-05,1,1,2,4,25,25,50
2020-04-06,3,0,1,4,75,0,25
2020-04-07,3,0,4,7,42.85714286,0,57.14285714
2020-04-08,2,2,4,8,25,25,50
2020-04-09,5,3,1,9,55.55555556,33.33333333,11.11111111
2020-04-10,1,1,3,5,20,20,60
2020-04-11,2,2,1,5,40,40,20
2020-04-12,1,1,2,4,25,25,50
2020-04-13,2,4,3,9,22.22222222,44.44444444,33.33333333
2020-04-14,1,0,3,4,25,0,75
2020-04-15,0,2,4,6,0,33.33333333,66.66666667
2020-04-16,2,1,5,8,25,12.5,62.5
2020-04-17,0,1,1,2,0,50,50
2020-04-18,2,2,2,6,33.33333333,33.33333333,33.33333333
2020-04-19,0,1,2,3,0,33.33333333,66.66666667
2020-04-20,4,1,4,9,44.44444444,11.11111111,44.44444444
2020-04-21,3,2,3,8,37.5,25,37.5
2020-04-22,2,0,7,9,22.22222222,0,77.77777778
2020-04-23,4,1,3,8,50,12.5,37.5
2020-04-24,1,4,2,7,14.28571429,57.14285714,28.57142857
2020-04-25,2,1,1,4,50,25,25
2020-04-26,2,3,3,8,25,37.5,37.5
2020-04-27,2,1,5,8,25,12.5,62.5
2020-04-28,2,1,4,7,28.57142857,14.28571429,57.14285714
2020-04-29,1,1,7,9,11.11111111,11.11111111,77.77777778
2020-04-30,6,0,1,7,85.71428571,0,14.28571429
2020-05-01,2,1,3,6,33.33333333,16.66666667,50
2020-05-02,0,1,2,3,0,33.33333333,66.66666667
2020-05-03,2,1,1,4,50,25,25
2020-05-04,4,0,5,9,44.44444444,0,55.55555556
2020-05-05,3,1,5,9,33.33333333,11.11111111,55.55555556
2020-05-06,3,2,4,9,33.33333333,22.22222222,44.44444444
2020-05-07,2,1,5,8,25,12.5,62.5
2020-05-08,2,2,3,7,28.57142857,28.57142857,42.85714286
2020-05-09,3,1,2,6,50,16.66666667,33.33333333
2020-05-10,1,1,2,4,25,25,50
2020-05-11,3,1,5,9,33.33333333,11.11111111,55.55555556
2020-05-12,2,1,7,10,20,10,70
2020-05-13,3,1,4,8,37.5,12.5,50
2020-05-14,3,0,2,5,60,0,40
2020-05-15,1,2,2,5,20,40,40
2020-05-16,2,1,1,4,50,25,25
2020-05-17,0,0,1,1,0,0,100
2020-05-18,2,0,2,4,50,0,50
2020-05-19,3,1,2,6,50,16.66666667,33.33333333
2020-05-20,2,1,6,9,22.22222222,11.11111111,66.66666667
2020-05-21,2,2,3,7,28.57142857,28.57142857,42.85714286
2020-05-22,3,1,1,5,60,20,20
2020-05-23,1,1,2,4,25,25,50
2020-05-25,1,1,5,7,14.28571429,14.28571429,71.42857143
2020-05-26,1,3,3,7,14.28571429,42.85714286,42.85714286
2020-05-27,2,1,3,6,33.33333333,16.66666667,50
2020-05-28,3,2,5,10,30,20,50
2020-05-29,0,1,2,3,0,33.33333333,66.66666667
2020-05-30,1,0,4,5,20,0,80
2020-05-31,3,0,0,3,100,0,0
2020-06-01,2,3,3,8,25,37.5,37.5
2020-06-02,3,0,6,9,33.33333333,0,66.66666667
2020-06-03,0,2,4,6,0,33.33333333,66.66666667
2020-06-04,4,4,2,10,40,40,20
2020-06-05,0,2,4,6,0,33.33333333,66.66666667
2020-06-06,1,4,3,8,12.5,50,37.5
2020-06-07,2,2,1,5,40,40,20
2020-06-08,1,2,5,8,12.5,25,62.5
2020-06-09,2,1,3,6,33.33333333,16.66666667,50
2020-06-10,1,1,8,10,10,10,80
2020-06-11,2,1,6,9,22.22222222,11.11111111,66.66666667
2020-06-12,1,2,3,6,16.66666667,33.33333333,50
2020-06-13,0,2,3,5,0,40,60
2020-06-14,1,1,0,2,50,50,0
2020-06-15,3,2,4,9,33.33333333,22.22222222,44.44444444
2020-06-16,0,3,3,6,0,50,50
2020-06-17,4,2,2,8,50,25,25
2020-06-18,0,3,2,5,0,60,40
2020-06-19,3,3,2,8,37.5,37.5,25
2020-06-20,0,2,5,7,0,28.57142857,71.42857143
2020-06-21,0,1,3,4,0,25,75
2020-06-22,1,2,3,6,16.66666667,33.33333333,50
2020-06-23,2,1,3,6,33.33333333,16.66666667,50
2020-06-24,3,3,2,8,37.5,37.5,25
2020-06-25,3,1,4,8,37.5,12.5,50
2020-06-26,1,3,3,7,14.28571429,42.85714286,42.85714286
2020-06-27,2,0,3,5,40,0,60
2020-06-28,1,1,0,2,50,50,0
2020-06-29,4,3,2,9,44.44444444,33.33333333,22.22222222
2020-06-30,2,3,4,9,22.22222222,33.33333333,44.44444444
2020-07-01,3,1,1,5,60,20,20
2020-07-02,3,3,3,9,33.33333333,33.33333333,33.33333333
2020-07-03,1,1,2,4,25,25,50
2020-07-04,2,0,2,4,50,0,50
2020-07-05,1,1,3,5,20,20,60
2020-07-06,3,1,4,8,37.5,12.5,50
2020-07-07,3,2,3,8,37.5,25,37.5
2020-07-08,3,2,3,8,37.5,25,37.5
2020-07-09,0,5,5,10,0,50,50
2020-07-10,2,2,2,6,33.33333333,33.33333333,33.33333333
2020-07-11,0,2,3,5,0,40,60
2020-07-12,1,3,4,8,12.5,37.5,50
2020-07-13,1,1,4,6,16.66666667,16.66666667,66.66666667
2020-07-14,2,3,2,7,28.57142857,42.85714286,28.57142857
2020-07-15,5,4,0,9,55.55555556,44.44444444,0
2020-07-16,2,1,5,8,25,12.5,62.5
2020-07-17,3,0,1,4,75,0,25
2020-07-18,1,3,0,4,25,75,0
2020-07-19,1,1,4,6,16.66666667,16.66666667,66.66666667
2020-07-20,2,2,4,8,25,25,50
2020-07-21,2,2,1,5,40,40,20
2020-07-22,0,1,3,4,0,25,75
2020-07-23,3,2,4,9,33.33333333,22.22222222,44.44444444
2020-07-24,3,1,5,9,33.33333333,11.11111111,55.55555556
2020-07-25,2,3,3,8,25,37.5,37.5
2020-07-26,1,1,3,5,20,20,60
2020-07-27,1,3,5,9,11.11111111,33.33333333,55.55555556
2020-07-28,3,0,7,10,30,0,70
2020-07-29,6,1,3,10,60,10,30
2020-07-30,3,2,4,9,33.33333333,22.22222222,44.44444444
2020-07-31,1,3,3,7,14.28571429,42.85714286,42.85714286
2020-08-01,4,0,1,5,80,0,20
2020-08-02,3,1,3,7,42.85714286,14.28571429,42.85714286
2020-08-03,1,4,3,8,12.5,50,37.5
2020-08-04,2,1,6,9,22.22222222,11.11111111,66.66666667
2020-08-05,1,2,4,7,14.28571429,28.57142857,57.14285714
2020-08-06,4,1,4,9,44.44444444,11.11111111,44.44444444
2020-08-07,0,1,7,8,0,12.5,87.5
2020-08-08,0,0,5,5,0,0,100
2020-08-09,2,0,3,5,40,0,60
2020-08-10,2,1,4,7,28.57142857,14.28571429,57.14285714
2020-08-11,3,3,4,10,30,30,40
2020-08-12,5,0,2,7,71.42857143,0,28.57142857
2020-08-13,5,3,2,10,50,30,20
2020-08-14,3,2,3,8,37.5,25,37.5
2020-08-15,3,1,3,7,42.85714286,14.28571429,42.85714286
2020-08-16,0,1,1,2,0,50,50
2020-08-17,2,1,5,8,25,12.5,62.5
2020-08-18,1,0,6,7,14.28571429,0,85.71428571
2020-08-19,2,3,2,7,28.57142857,42.85714286,28.57142857
2020-08-20,1,1,6,8,12.5,12.5,75
2020-08-21,1,4,5,10,10,40,50
2020-08-22,1,2,1,4,25,50,25
2020-08-23,0,0,4,4,0,0,100
2020-08-24,1,2,5,8,12.5,25,62.5
2020-08-25,2,1,3,6,33.33333333,16.66666667,50
2020-08-26,3,0,5,8,37.5,0,62.5
2020-08-27,4,2,3,9,44.44444444,22.22222222,33.33333333
2020-08-28,3,2,3,8,37.5,25,37.5
2020-08-29,1,0,3,4,25,0,75
2020-08-30,1,2,3,6,16.66666667,33.33333333,50
2020-08-31,1,3,4,8,12.5,37.5,50
2020-09-01,3,2,2,7,42.85714286,28.57142857,28.57142857
2020-09-02,1,2,4,7,14.28571429,28.57142857,57.14285714
2020-09-03,3,0,4,7,42.85714286,0,57.14285714
2020-09-04,2,2,3,7,28.57142857,28.57142857,42.85714286
2020-09-05,0,1,3,4,0,25,75
2020-09-06,1,2,0,3,33.33333333,66.66666667,0
2020-09-07,3,0,5,8,37.5,0,62.5
2020-09-08,3,0,7,10,30,0,70
2020-09-09,1,1,5,7,14.28571429,14.28571429,71.42857143
2020-09-10,3,3,1,7,42.85714286,42.85714286,14.28571429
2020-09-11,2,1,5,8,25,12.5,62.5
2020-09-12,1,0,1,2,50,0,50
2020-09-13,3,1,4,8,37.5,12.5,50
2020-09-14,3,2,4,9,33.33333333,22.22222222,44.44444444
2020-09-15,3,1,4,8,37.5,12.5,50
2020-09-16,4,1,2,7,57.14285714,14.28571429,28.57142857
2020-09-17,3,0,3,6,50,0,50
2020-09-18,4,2,2,8,50,25,25
2020-09-19,2,0,3,5,40,0,60
2020-09-20,0,2,0,2,0,100,0
2020-09-21,5,1,2,8,62.5,12.5,25
2020-09-22,0,2,2,4,0,50,50
2020-09-23,1,1,7,9,11.11111111,11.11111111,77.77777778
2020-09-24,2,2,3,7,28.57142857,28.57142857,42.85714286
2020-09-25,1,3,3,7,14.28571429,42.85714286,42.85714286
2020-09-26,1,3,1,5,20,60,20
2020-09-27,1,3,1,5,20,60,20
2020-09-28,3,1,4,8,37.5,12.5,50
2020-09-29,3,2,4,9,33.33333333,22.22222222,44.44444444
2020-09-30,0,4,2,6,0,66.66666667,33.33333333
2020-10-01,2,2,5,9,22.22222222,22.22222222,55.55555556
2020-10-02,0,1,3,4,0,25,75
2020-10-03,1,2,1,4,25,50,25
2020-10-04,4,0,2,6,66.66666667,0,33.33333333
2020-10-05,3,1,5,9,33.33333333,11.11111111,55.55555556
2020-10-06,1,3,2,6,16.66666667,50,33.33333333
2020-10-07,1,1,3,5,20,20,60
2020-10-08,2,2,5,9,22.22222222,22.22222222,55.55555556
2020-10-09,1,1,6,8,12.5,12.5,75
2020-10-10,1,0,1,2,50,0,50
2020-10-11,2,0,0,2,100,0,0
2020-10-12,4,0,6,10,40,0,60
2020-10-13,4,1,4,9,44.44444444,11.11111111,44.44444444
2020-10-14,3,1,6,10,30,10,60
2020-10-15,1,1,5,7,14.28571429,14.28571429,71.42857143
2020-10-16,3,0,5,8,37.5,0,62.5
2020-10-17,1,1,3,5,20,20,60
2020-10-18,0,1,5,6,0,16.66666667,83.33333333
2020-10-19,2,1,6,9,22.22222222,11.11111111,66.66666667
2020-10-20,2,2,4,8,25,25,50
2020-10-21,4,4,1,9,44.44444444,44.44444444,11.11111111
2020-10-22,6,0,1,7,85.71428571,0,14.28571429
2020-10-23,2,1,4,7,28.57142857,14.28571429,57.14285714
2020-10-24,3,1,3,7,42.85714286,14.28571429,42.85714286
2020-10-25,0,1,5,6,0,16.66666667,83.33333333
2020-10-26,4,1,3,8,50,12.5,37.5
2020-10-27,3,1,6,10,30,10,60
2020-10-28,3,1,3,7,42.85714286,14.28571429,42.85714286
2020-10-29,3,0,5,8,37.5,0,62.5
2020-10-30,2,1,2,5,40,20,40
2020-10-31,2,0,5,7,28.57142857,0,71.42857143
2020-11-01,2,1,2,5,40,20,40
2020-11-02,0,0,6,6,0,0,100
2020-11-03,3,1,5,9,33.33333333,11.11111111,55.55555556
2020-11-04,1,2,3,6,16.66666667,33.33333333,50
2020-11-05,4,0,6,10,40,0,60
2020-11-06,0,2,6,8,0,25,75
2020-11-07,0,1,1,2,0,50,50
2020-11-08,1,0,3,4,25,0,75
2020-11-09,0,4,4,8,0,50,50
2020-11-10,4,2,3,9,44.44444444,22.22222222,33.33333333
2020-11-11,2,3,5,10,20,30,50
2020-11-12,4,1,2,7,57.14285714,14.28571429,28.57142857
2020-11-13,5,0,4,9,55.55555556,0,44.44444444
2020-11-14,1,1,3,5,20,20,60
2020-11-15,3,2,1,6,50,33.33333333,16.66666667
2020-11-16,1,3,5,9,11.11111111,33.33333333,55.55555556
2020-11-17,1,2,5,8,12.5,25,62.5
2020-11-18,2,1,7,10,20,10,70
2020-11-19,2,2,6,10,20,20,60
2020-11-20,2,0,5,7,28.57142857,0,71.42857143
2020-11-21,3,1,1,5,60,20,20
2020-11-22,1,0,0,1,100,0,0
2020-11-23,0,0,7,7,0,0,100
2020-11-24,2,1,6,9,22.22222222,11.11111111,66.66666667
2020-11-25,5,1,4,10,50,10,40
2020-11-26,1,1,8,10,10,10,80
2020-11-27,5,1,3,9,55.55555556,11.11111111,33.33333333
2020-11-28,1,3,4,8,12.5,37.5,50
2020-11-29,3,1,2,6,50,16.66666667,33.33333333
2020-11-30,2,0,7,9,22.22222222,0,77.77777778
2020-12-01,2,3,5,10,20,30,50
2020-12-02,7,1,2,10,70,10,20
2020-12-03,2,1,6,9,22.22222222,11.11111111,66.66666667
2020-12-04,3,0,7,10,30,0,70
2020-12-05,3,2,1,6,50,33.33333333,16.66666667
2020-12-06,3,0,2,5,60,0,40
2020-12-07,2,4,3,9,22.22222222,44.44444444,33.33333333
2020-12-08,3,3,3,9,33.33333333,33.33333333,33.33333333
2020-12-09,3,3,2,8,37.5,37.5,25
2020-12-10,2,1,5,8,25,12.5,62.5
2020-12-11,1,1,8,10,10,10,80
2020-12-12,5,1,2,8,62.5,12.5,25
2020-12-13,3,2,1,6,50,33.33333333,16.66666667
2020-12-14,3,2,3,8,37.5,25,37.5
2020-12-15,4,0,3,7,57.14285714,0,42.85714286
2020-12-16,4,2,4,10,40,20,40
2020-12-17,2,1,7,10,20,10,70
2020-12-18,5,2,3,10,50,20,30
2020-12-19,1,0,5,6,16.66666667,0,83.33333333
2020-12-20,3,3,4,10,30,30,40
2020-12-21,3,3,2,8,37.5,37.5,25
2020-12-22,2,4,4,10,20,40,40
2020-12-23,4,1,4,9,44.44444444,11.11111111,44.44444444
2020-12-24,5,1,3,9,55.55555556,11.11111111,33.33333333
2020-12-25,1,0,4,5,20,0,80
2020-12-26,4,0,2,6,66.66666667,0,33.33333333
2020-12-27,3,1,3,7,42.85714286,14.28571429,42.85714286
2020-12-28,3,0,5,8,37.5,0,62.5
2020-12-29,2,0,6,8,25,0,75
2020-12-30,2,1,6,9,22.22222222,11.11111111,66.66666667
2020-12-31,2,1,2,5,40,20,40
2021-01-01,1,2,5,8,12.5,25,62.5
2021-01-02,3,0,6,9,33.33333333,0,66.66666667
2021-01-03,4,1,5,10,40,10,50
2021-01-04,2,3,4,9,22.22222222,33.33333333,44.44444444
2021-01-05,4,3,3,10,40,30,30
2021-01-06,2,1,7,10,20,10,70
2021-01-07,4,1,5,10,40,10,50
2021-01-08,4,1,5,10,40,10,50
2021-01-09,4,3,3,10,40,30,30
2021-01-10,1,3,5,9,11.11111111,33.33333333,55.55555556
2021-01-11,2,3,4,9,22.22222222,33.33333333,44.44444444
2021-01-12,4,3,3,10,40,30,30
2021-01-13,3,2,5,10,30,20,50
2021-01-14,4,3,3,10,40,30,30
2021-01-15,3,3,3,9,33.33333333,33.33333333,33.33333333
2021-01-16,1,2,4,7,14.28571429,28.57142857,57.14285714
2021-01-17,3,1,4,8,37.5,12.5,50
2021-01-18,1,4,4,9,11.11111111,44.44444444,44.44444444
2021-01-19,1,1,7,9,11.11111111,11.11111111,77.77777778
2021-01-20,4,2,4,10,40,20,40
2021-01-21,6,3,1,10,60,30,10
2021-01-22,1,2,6,9,11.11111111,22.22222222,66.66666667
2021-01-23,3,2,4,9,33.33333333,22.22222222,44.44444444
2021-01-24,2,4,2,8,25,50,25
2021-01-25,2,1,7,10,20,10,70
2021-01-26,6,0,2,8,75,0,25
2021-01-27,4,2,4,10,40,20,40
2021-01-28,2,3,5,10,20,30,50
2021-01-29,0,0,10,10,0,0,100
2021-01-30,1,2,3,6,16.66666667,33.33333333,50
2021-01-31,3,2,2,7,42.85714286,28.57142857,28.57142857
2021-02-01,3,1,5,9,33.33333333,11.11111111,55.55555556
2021-02-02,2,0,8,10,20,0,80
2021-02-03,3,0,7,10,30,0,70
2021-02-04,3,3,4,10,30,30,40
2021-02-05,2,5,3,10,20,50,30
2021-02-06,2,1,6,9,22.22222222,11.11111111,66.66666667
2021-02-07,5,2,2,9,55.55555556,22.22222222,22.22222222
2021-02-08,2,1,7,10,20,10,70
2021-02-09,4,1,5,10,40,10,50
2021-02-10,4,1,5,10,40,10,50
2021-02-11,7,2,1,10,70,20,10
2021-02-12,2,1,7,10,20,10,70
2021-02-13,3,3,3,9,33.33333333,33.33333333,33.33333333
2021-02-14,3,1,4,8,37.5,12.5,50
2021-02-15,2,2,6,10,20,20,60
2021-02-16,3,2,3,8,37.5,25,37.5
2021-02-17,2,2,6,10,20,20,60
2021-02-18,6,1,3,10,60,10,30
2021-02-19,3,0,6,9,33.33333333,0,66.66666667
2021-02-20,5,0,4,9,55.55555556,0,44.44444444
2021-02-21,3,0,5,8,37.5,0,62.5
2021-02-22,2,2,6,10,20,20,60
2021-02-23,4,3,2,9,44.44444444,33.33333333,22.22222222
2021-02-24,5,2,3,10,50,20,30
2021-02-25,4,2,4,10,40,20,40
2021-02-26,2,2,5,9,22.22222222,22.22222222,55.55555556
2021-02-27,4,0,3,7,57.14285714,0,42.85714286
2021-02-28,4,1,1,6,66.66666667,16.66666667,16.66666667
2021-03-01,1,3,6,10,10,30,60
2021-03-02,3,1,6,10,30,10,60
2021-03-03,3,2,5,10,30,20,50
2021-03-04,1,3,6,10,10,30,60
2021-03-05,3,1,5,9,33.33333333,11.11111111,55.55555556
2021-03-06,3,1,2,6,50,16.66666667,33.33333333
2021-03-07,0,1,4,5,0,20,80
2021-03-08,4,0,6,10,40,0,60
2021-03-09,2,2,6,10,20,20,60
2021-03-10,2,4,4,10,20,40,40
2021-03-11,7,1,2,10,70,10,20
2021-03-12,0,8,1,9,0,88.88888889,11.11111111
2021-03-13,2,1,7,10,20,10,70
2021-03-14,5,1,1,7,71.42857143,14.28571429,14.28571429
2021-03-15,3,1,4,8,37.5,12.5,50
2021-03-16,5,0,3,8,62.5,0,37.5
2021-03-17,3,1,5,9,33.33333333,11.11111111,55.55555556
2021-03-18,1,1,8,10,10,10,80
2021-03-19,1,2,7,10,10,20,70
2021-03-20,2,1,2,5,40,20,40
2021-03-21,1,1,3,5,20,20,60
2021-03-22,7,0,3,10,70,0,30
2021-03-23,3,1,5,9,33.33333333,11.11111111,55.55555556
2021-03-24,2,3,5,10,20,30,50
2021-03-25,2,1,6,9,22.22222222,11.11111111,66.66666667
2021-03-26,4,0,6,10,40,0,60
2021-03-27,1,2,4,7,14.28571429,28.57142857,57.14285714
2021-03-28,0,2,6,8,0,25,75
2021-03-29,2,1,7,10,20,10,70
2021-03-30,7,0,3,10,70,0,30
2021-03-31,4,0,4,8,50,0,50
2021-04-01,5,1,3,9,55.55555556,11.11111111,33.33333333
2021-04-02,2,2,6,10,20,20,60
2021-04-03,3,0,6,9,33.33333333,0,66.66666667
2021-04-04,1,2,5,8,12.5,25,62.5
2021-04-05,1,2,7,10,10,20,70
2021-04-06,3,0,5,8,37.5,0,62.5
2021-04-07,0,2,7,9,0,22.22222222,77.77777778
2021-04-08,1,1,7,9,11.11111111,11.11111111,77.77777778
2021-04-09,3,1,4,8,37.5,12.5,50
2021-04-10,3,3,3,9,33.33333333,33.33333333,33.33333333
2021-04-11,5,2,2,9,55.55555556,22.22222222,22.22222222
2021-04-12,2,1,5,8,25,12.5,62.5
2021-04-13,2,1,7,10,20,10,70
2021-04-14,4,0,5,9,44.44444444,0,55.55555556
2021-04-15,5,1,4,10,50,10,40
2021-04-16,4,1,5,10,40,10,50
2021-04-17,2,2,5,9,22.22222222,22.22222222,55.55555556
2021-04-18,0,2,7,9,0,22.22222222,77.77777778
2021-04-19,1,3,5,9,11.11111111,33.33333333,55.55555556
2021-04-20,5,2,3,10,50,20,30
2021-04-21,5,0,5,10,50,0,50
2021-04-22,4,4,2,10,40,40,20
2021-04-23,4,1,5,10,40,10,50
2021-04-24,4,2,1,7,57.14285714,28.57142857,14.28571429
2021-04-25,2,2,5,9,22.22222222,22.22222222,55.55555556
2021-04-26,6,0,4,10,60,0,40
2021-04-27,5,0,4,9,55.55555556,0,44.44444444
2021-04-28,4,4,2,10,40,40,20
2021-04-29,3,1,5,9,33.33333333,11.11111111,55.55555556
2021-04-30,1,3,4,8,12.5,37.5,50
2021-05-01,1,2,6,9,11.11111111,22.22222222,66.66666667
2021-05-02,2,2,3,7,28.57142857,28.57142857,42.85714286
2021-05-03,5,0,3,8,62.5,0,37.5
2021-05-04,3,1,6,10,30,10,60
2021-05-05,3,1,6,10,30,10,60
2021-05-06,3,0,7,10,30,0,70
2021-05-07,4,1,4,9,44.44444444,11.11111111,44.44444444
2021-05-08,2,1,2,5,40,20,40
2021-05-09,2,0,7,9,22.22222222,0,77.77777778
2021-05-10,4,2,3,9,44.44444444,22.22222222,33.33333333
2021-05-11,3,0,7,10,30,0,70
2021-05-12,4,2,3,9,44.44444444,22.22222222,33.33333333
2021-05-13,2,4,4,10,20,40,40
2021-05-14,4,1,5,10,40,10,50
2021-05-15,2,1,3,6,33.33333333,16.66666667,50
2021-05-16,5,2,3,10,50,20,30
2021-05-17,3,3,3,9,33.33333333,33.33333333,33.33333333
2021-05-18,5,3,1,9,55.55555556,33.33333333,11.11111111
2021-05-19,3,5,1,9,33.33333333,55.55555556,11.11111111
2021-05-20,5,1,3,9,55.55555556,11.11111111,33.33333333
2021-05-21,3,1,4,8,37.5,12.5,50
2021-05-22,5,4,1,10,50,40,10
2021-05-23,1,1,7,9,11.11111111,11.11111111,77.77777778
2021-05-24,2,3,5,10,20,30,50
2021-05-25,2,0,7,9,22.22222222,0,77.77777778
2021-05-26,3,3,4,10,30,30,40
2021-05-27,4,1,5,10,40,10,50
2021-05-28,3,2,5,10,30,20,50
2021-05-29,4,1,5,10,40,10,50
2021-05-30,1,1,3,5,20,20,60
2021-05-31,2,3,4,9,22.22222222,33.33333333,44.44444444
2021-06-01,2,3,4,9,22.22222222,33.33333333,44.44444444
2021-06-02,4,2,4,10,40,20,40
2021-06-03,2,2,6,10,20,20,60
2021-06-04,1,1,8,10,10,10,80
2021-06-05,1,0,4,5,20,0,80
2021-06-06,1,3,4,8,12.5,37.5,50
2021-06-07,5,1,3,9,55.55555556,11.11111111,33.33333333
2021-06-08,4,2,2,8,50,25,25
2021-06-09,3,0,4,7,42.85714286,0,57.14285714
2021-06-10,3,5,2,10,30,50,20
2021-06-11,2,2,5,9,22.22222222,22.22222222,55.55555556
2021-06-12,3,0,5,8,37.5,0,62.5
2021-06-13,3,4,2,9,33.33333333,44.44444444,22.22222222
2021-06-14,4,2,4,10,40,20,40
2021-06-15,2,0,6,8,25,0,75
2021-06-16,5,0,3,8,62.5,0,37.5
2021-06-17,2,1,5,8,25,12.5,62.5
2021-06-18,5,0,4,9,55.55555556,0,44.44444444
2021-06-19,3,4,2,9,33.33333333,44.44444444,22.22222222
2021-06-20,4,2,4,10,40,20,40
2021-06-21,3,7,0,10,30,70,0
2021-06-22,1,5,4,10,10,50,40
2021-06-23,3,2,5,10,30,20,50
2021-06-24,5,3,2,10,50,30,20
2021-06-25,4,2,3,9,44.44444444,22.22222222,33.33333333
2021-06-26,2,3,5,10,20,30,50
2021-06-27,4,0,2,6,66.66666667,0,33.33333333
2021-06-28,2,4,3,9,22.22222222,44.44444444,33.33333333
2021-06-29,5,3,2,10,50,30,20
2021-06-30,1,4,5,10,10,40,50
2021-07-01,1,4,5,10,10,40,50
2021-07-02,5,2,2,9,55.55555556,22.22222222,22.22222222
2021-07-03,6,2,2,10,60,20,20
2021-07-04,4,0,6,10,40,0,60
2021-07-05,3,2,5,10,30,20,50
2021-07-06,2,4,3,9,22.22222222,44.44444444,33.33333333
2021-07-07,1,3,5,9,11.11111111,33.33333333,55.55555556
2021-07-08,4,1,5,10,40,10,50
2021-07-09,2,2,3,7,28.57142857,28.57142857,42.85714286
2021-07-10,2,6,2,10,20,60,20
2021-07-11,3,2,1,6,50,33.33333333,16.66666667
2021-07-12,3,3,3,9,33.33333333,33.33333333,33.33333333
2021-07-13,2,2,6,10,20,20,60
2021-07-14,3,5,2,10,30,50,20
2021-07-15,3,3,4,10,30,30,40
2021-07-16,4,1,5,10,40,10,50
2021-07-17,2,2,3,7,28.57142857,28.57142857,42.85714286
2021-07-18,5,1,4,10,50,10,40
2021-07-19,5,2,3,10,50,20,30
2021-07-20,2,5,3,10,20,50,30
2021-07-21,1,2,5,8,12.5,25,62.5
2021-07-22,3,0,4,7,42.85714286,0,57.14285714
2021-07-23,3,1,6,10,30,10,60
2021-07-24,7,0,3,10,70,0,30
2021-07-25,6,1,1,8,75,12.5,12.5
2021-07-26,5,0,5,10,50,0,50
2021-07-27,3,1,5,9,33.33333333,11.11111111,55.55555556
2021-07-28,5,2,3,10,50,20,30
2021-07-29,2,0,7,9,22.22222222,0,77.77777778
2021-07-30,2,2,6,10,20,20,60
2021-07-31,3,3,3,9,33.33333333,33.33333333,33.33333333
2021-08-01,1,1,5,7,14.28571429,14.28571429,71.42857143
2021-08-02,5,2,3,10,50,20,30
2021-08-03,1,1,6,8,12.5,12.5,75
2021-08-04,3,1,6,10,30,10,60
2021-08-05,4,0,6,10,40,0,60
2021-08-06,1,2,6,9,11.11111111,22.22222222,66.66666667
2021-08-07,6,2,0,8,75,25,0
2021-08-08,2,2,5,9,22.22222222,22.22222222,55.55555556
2021-08-09,3,1,6,10,30,10,60
2021-08-10,6,1,3,10,60,10,30
2021-08-11,4,1,5,10,40,10,50
2021-08-12,2,0,7,9,22.22222222,0,77.77777778
2021-08-13,3,0,7,10,30,0,70
2021-08-14,2,1,4,7,28.57142857,14.28571429,57.14285714
2021-08-15,5,0,3,8,62.5,0,37.5
2021-08-16,2,1,7,10,20,10,70
2021-08-17,4,0,5,9,44.44444444,0,55.55555556
2021-08-18,4,0,5,9,44.44444444,0,55.55555556
2021-08-19,6,0,3,9,66.66666667,0,33.33333333
2021-08-20,6,2,2,10,60,20,20
2021-08-21,2,2,4,8,25,25,50
2021-08-22,3,2,5,10,30,20,50
2021-08-23,4,1,4,9,44.44444444,11.11111111,44.44444444
2021-08-24,6,1,1,8,75,12.5,12.5
2021-08-25,3,2,5,10,30,20,50
2021-08-26,2,1,6,9,22.22222222,11.11111111,66.66666667
2021-08-27,4,1,4,9,44.44444444,11.11111111,44.44444444
2021-08-28,2,0,5,7,28.57142857,0,71.42857143
2021-08-29,6,1,2,9,66.66666667,11.11111111,22.22222222
2021-08-30,3,1,5,9,33.33333333,11.11111111,55.55555556
2021-08-31,6,1,2,9,66.66666667,11.11111111,22.22222222
2021-09-01,2,3,5,10,20,30,50
2021-09-02,4,2,4,10,40,20,40
2021-09-03,2,0,8,10,20,0,80
2021-09-04,3,1,2,6,50,16.66666667,33.33333333
2021-09-05,2,3,3,8,25,37.5,37.5
2021-09-06,2,1,4,7,28.57142857,14.28571429,57.14285714
2021-09-07,7,0,2,9,77.77777778,0,22.22222222
2021-09-08,3,5,2,10,30,50,20
2021-09-09,2,1,5,8,25,12.5,62.5
2021-09-10,4,1,4,9,44.44444444,11.11111111,44.44444444
2021-09-11,1,1,2,4,25,25,50
2021-09-12,3,1,4,8,37.5,12.5,50
2021-09-13,2,2,6,10,20,20,60
2021-09-14,2,2,6,10,20,20,60
2021-09-15,4,1,4,9,44.44444444,11.11111111,44.44444444
2021-09-16,4,1,4,9,44.44444444,11.11111111,44.44444444
2021-09-17,2,1,5,8,25,12.5,62.5
2021-09-18,3,0,4,7,42.85714286,0,57.14285714
2021-09-19,1,1,2,4,25,25,50
2021-09-20,2,1,6,9,22.22222222,11.11111111,66.66666667
2021-09-21,6,1,2,9,66.66666667,11.11111111,22.22222222
2021-09-22,1,1,7,9,11.11111111,11.11111111,77.77777778
2021-09-23,4,2,3,9,44.44444444,22.22222222,33.33333333
2021-09-24,4,2,3,9,44.44444444,22.22222222,33.33333333
2021-09-25,3,2,2,7,42.85714286,28.57142857,28.57142857
2021-09-26,1,4,0,5,20,80,0
2021-09-27,4,0,6,10,40,0,60
2021-09-28,3,0,5,8,37.5,0,62.5
2021-09-29,3,1,6,10,30,10,60
2021-09-30,5,3,2,10,50,30,20
2021-10-01,4,1,4,9,44.44444444,11.11111111,44.44444444
2021-10-02,5,1,2,8,62.5,12.5,25
2021-10-03,4,0,3,7,57.14285714,0,42.85714286
2021-10-04,1,1,7,9,11.11111111,11.11111111,77.77777778
2021-10-05,4,1,4,9,44.44444444,11.11111111,44.44444444
2021-10-06,5,0,4,9,55.55555556,0,44.44444444
2021-10-07,2,2,6,10,20,20,60
2021-10-08,3,1,5,9,33.33333333,11.11111111,55.55555556
2021-10-09,5,1,2,8,62.5,12.5,25
2021-10-10,5,1,1,7,71.42857143,14.28571429,14.28571429
2021-10-11,1,2,5,8,12.5,25,62.5
2021-10-12,3,1,6,10,30,10,60
2021-10-13,3,1,6,10,30,10,60
2021-10-14,4,1,4,9,44.44444444,11.11111111,44.44444444
2021-10-15,6,1,3,10,60,10,30
2021-10-16,1,0,3,4,25,0,75
2021-10-17,1,1,5,7,14.28571429,14.28571429,71.42857143
2021-10-18,6,1,3,10,60,10,30
2021-10-19,3,1,4,8,37.5,12.5,50
2021-10-20,3,0,7,10,30,0,70
2021-10-21,4,0,5,9,44.44444444,0,55.55555556
2021-10-22,2,1,6,9,22.22222222,11.11111111,66.66666667
2021-10-23,2,0,3,5,40,0,60
2021-10-24,2,1,3,6,33.33333333,16.66666667,50
2021-10-25,2,1,5,8,25,12.5,62.5
2021-10-26,4,0,6,10,40,0,60
2021-10-27,2,3,5,10,20,30,50
2021-10-28,3,0,6,9,33.33333333,0,66.66666667
2021-10-29,2,1,5,8,25,12.5,62.5
2021-10-30,2,2,6,10,20,20,60
2021-10-31,1,3,4,8,12.5,37.5,50
2021-11-01,2,0,4,6,33.33333333,0,66.66666667
2021-11-02,6,0,3,9,66.66666667,0,33.33333333
2021-11-03,2,1,6,9,22.22222222,11.11111111,66.66666667
2021-11-04,5,2,3,10,50,20,30
2021-11-05,4,3,2,9,44.44444444,33.33333333,22.22222222
2021-11-06,0,0,1,1,0,0,100
2021-11-07,0,2,6,8,0,25,75
2021-11-08,2,0,8,10,20,0,80
2021-11-09,2,0,8,10,20,0,80
2021-11-10,3,2,5,10,30,20,50
2021-11-11,4,0,6,10,40,0,60
2021-11-12,0,2,7,9,0,22.22222222,77.77777778
2021-11-13,3,2,3,8,37.5,25,37.5
2021-11-14,2,2,5,9,22.22222222,22.22222222,55.55555556
2021-11-15,2,2,5,9,22.22222222,22.22222222,55.55555556
2021-11-16,7,0,3,10,70,0,30
2021-11-17,2,4,4,10,20,40,40
2021-11-18,2,1,5,8,25,12.5,62.5
2021-11-19,2,3,5,10,20,30,50
2021-11-20,3,0,6,9,33.33333333,0,66.66666667
2021-11-21,4,1,5,10,40,10,50
2021-11-22,5,2,2,9,55.55555556,22.22222222,22.22222222
2021-11-23,1,2,6,9,11.11111111,22.22222222,66.66666667
2021-11-24,5,0,4,9,55.55555556,0,44.44444444
2021-11-25,4,2,4,10,40,20,40
2021-11-26,2,2,4,8,25,25,50
2021-11-27,0,2,4,6,0,33.33333333,66.66666667
2021-11-28,1,3,3,7,14.28571429,42.85714286,42.85714286
2021-11-29,3,1,5,9,33.33333333,11.11111111,55.55555556
2021-11-30,3,1,6,10,30,10,60
2021-12-01,3,3,4,10,30,30,40
2021-12-02,4,1,4,9,44.44444444,11.11111111,44.44444444
2021-12-03,6,1,2,9,66.66666667,11.11111111,22.22222222
2021-12-04,2,3,4,9,22.22222222,33.33333333,44.44444444
2021-12-05,3,2,5,10,30,20,50
2021-12-06,3,3,2,8,37.5,37.5,25
2021-12-07,3,4,3,10,30,40,30
2021-12-08,5,0,4,9,55.55555556,0,44.44444444
2021-12-09,1,3,6,10,10,30,60
2021-12-10,4,3,3,10,40,30,30
2021-12-11,0,0,6,6,0,0,100
2021-12-12,1,1,3,5,20,20,60
2021-12-13,5,0,5,10,50,0,50
2021-12-14,3,2,3,8,37.5,25,37.5
2021-12-15,2,2,4,8,25,25,50
2021-12-16,2,2,5,9,22.22222222,22.22222222,55.55555556
2021-12-17,2,6,1,9,22.22222222,66.66666667,11.11111111
2021-12-18,4,2,4,10,40,20,40
2021-12-19,1,3,3,7,14.28571429,42.85714286,42.85714286
2021-12-20,3,1,5,9,33.33333333,11.11111111,55.55555556
2021-12-21,3,0,6,9,33.33333333,0,66.66666667
2021-12-22,5,1,3,9,55.55555556,11.11111111,33.33333333
2021-12-23,2,1,7,10,20,10,70
2021-12-24,4,1,4,9,44.44444444,11.11111111,44.44444444
2021-12-25,1,0,4,5,20,0,80
2021-12-26,2,3,4,9,22.22222222,33.33333333,44.44444444
2021-12-27,6,2,2,10,60,20,20
2021-12-28,1,2,6,9,11.11111111,22.22222222,66.66666667
2021-12-29,5,0,5,10,50,0,50
2021-12-30,3,3,2,8,37.5,37.5,25
2021-12-31,4,1,5,10,40,10,50
2022-01-01,2,1,5,8,25,12.5,62.5
2022-01-02,2,1,3,6,33.33333333,16.66666667,50
2022-01-03,2,1,7,10,20,10,70
2022-01-04,5,1,4,10,50,10,40
2022-01-05,2,2,5,9,22.22222222,22.22222222,55.55555556
2022-01-06,4,3,3,10,40,30,30
2022-01-07,2,2,3,7,28.57142857,28.57142857,42.85714286
2022-01-08,1,4,4,9,11.11111111,44.44444444,44.44444444
2022-01-09,1,3,3,7,14.28571429,42.85714286,42.85714286
2022-01-10,1,5,2,8,12.5,62.5,25
2022-01-11,3,2,5,10,30,20,50
2022-01-12,2,2,4,8,25,25,50
2022-01-13,2,3,5,10,20,30,50
2022-01-14,3,2,5,10,30,20,50
2022-01-15,2,2,4,8,25,25,50
2022-01-16,2,0,2,4,50,0,50
2022-01-17,0,0,9,9,0,0,100
2022-01-18,4,3,2,9,44.44444444,33.33333333,22.22222222
2022-01-19,4,2,3,9,44.44444444,22.22222222,33.33333333
2022-01-20,3,1,6,10,30,10,60
2022-01-21,3,4,3,10,30,40,30
2022-01-22,3,4,2,9,33.33333333,44.44444444,22.22222222
2022-01-23,2,1,3,6,33.33333333,16.66666667,50
2022-01-24,2,2,5,9,22.22222222,22.22222222,55.55555556
2022-01-25,3,3,3,9,33.33333333,33.33333333,33.33333333
2022-01-26,4,1,5,10,40,10,50
2022-01-27,5,1,3,9,55.55555556,11.11111111,33.33333333
2022-01-28,5,1,3,9,55.55555556,11.11111111,33.33333333
2022-01-29,2,0,3,5,40,0,60
2022-01-30,2,2,5,9,22.22222222,22.22222222,55.55555556
2022-01-31,0,4,5,9,0,44.44444444,55.55555556
2022-02-01,2,4,3,9,22.22222222,44.44444444,33.33333333
2022-02-02,4,1,3,8,50,12.5,37.5
2022-02-03,2,3,5,10,20,30,50
2022-02-04,4,0,5,9,44.44444444,0,55.55555556
2022-02-05,5,0,4,9,55.55555556,0,44.44444444
2022-02-06,3,1,4,8,37.5,12.5,50
2022-02-07,3,2,5,10,30,20,50
2022-02-08,2,0,8,10,20,0,80
2022-02-09,5,0,4,9,55.55555556,0,44.44444444
2022-02-10,4,0,6,10,40,0,60
2022-02-11,3,1,6,10,30,10,60
2022-02-12,6,0,4,10,60,0,40
2022-02-13,2,1,7,10,20,10,70
2022-02-14,3,1,5,9,33.33333333,11.11111111,55.55555556
2022-02-15,5,1,4,10,50,10,40
2022-02-16,3,2,4,9,33.33333333,22.22222222,44.44444444
2022-02-17,3,2,4,9,33.33333333,22.22222222,44.44444444
2022-02-18,3,2,4,9,33.33333333,22.22222222,44.44444444
2022-02-19,5,1,2,8,62.5,12.5,25
2022-02-20,3,1,4,8,37.5,12.5,50
2022-02-21,1,2,6,9,11.11111111,22.22222222,66.66666667
2022-02-22,2,3,4,9,22.22222222,33.33333333,44.44444444
2022-02-23,2,0,8,10,20,0,80
2022-02-24,3,4,3,10,30,40,30
2022-02-25,3,2,4,9,33.33333333,22.22222222,44.44444444
2022-02-26,1,2,5,8,12.5,25,62.5
2022-02-27,4,0,4,8,50,0,50
2022-02-28,1,1,7,9,11.11111111,11.11111111,77.77777778
2022-03-01,3,3,3,9,33.33333333,33.33333333,33.33333333
2022-03-02,4,2,4,10,40,20,40
2022-03-03,3,2,5,10,30,20,50
2022-03-04,4,1,3,8,50,12.5,37.5
2022-03-05,2,1,5,8,25,12.5,62.5
2022-03-06,3,1,6,10,30,10,60
2022-03-07,3,1,5,9,33.33333333,11.11111111,55.55555556
2022-03-08,4,6,0,10,40,60,0
2022-03-09,2,2,6,10,20,20,60
2022-03-10,4,2,3,9,44.44444444,22.22222222,33.33333333
2022-03-11,1,4,4,9,11.11111111,44.44444444,44.44444444
2022-03-12,2,1,7,10,20,10,70
2022-03-13,3,2,4,9,33.33333333,22.22222222,44.44444444
2022-03-14,2,6,2,10,20,60,20
2022-03-15,4,2,3,9,44.44444444,22.22222222,33.33333333
2022-03-16,2,1,5,8,25,12.5,62.5
2022-03-17,1,0,6,7,14.28571429,0,85.71428571
2022-03-18,2,4,4,10,20,40,40
2022-03-19,3,1,5,9,33.33333333,11.11111111,55.55555556
2022-03-20,5,0,1,6,83.33333333,0,16.66666667
2022-03-21,5,0,2,7,71.42857143,0,28.57142857
2022-03-22,5,0,3,8,62.5,0,37.5
2022-03-23,2,0,8,10,20,0,80
2022-03-24,4,2,4,10,40,20,40
2022-03-25,4,0,6,10,40,0,60
2022-03-26,1,1,6,8,12.5,12.5,75
2022-03-27,2,1,6,9,22.22222222,11.11111111,66.66666667
2022-03-28,2,0,4,6,33.33333333,0,66.66666667
2022-03-29,0,0,8,8,0,0,100
2022-03-30,2,2,6,10,20,20,60
2022-03-31,0,1,9,10,0,10,90
2022-04-01,1,4,5,10,10,40,50
2022-04-02,2,4,4,10,20,40,40
2022-04-03,0,0,5,5,0,0,100
2022-04-04,0,1,8,9,0,11.11111111,88.88888889
2022-04-05,5,0,3,8,62.5,0,37.5
2022-04-06,1,0,8,9,11.11111111,0,88.88888889
2022-04-07,1,2,6,9,11.11111111,22.22222222,66.66666667
2022-04-08,4,2,3,9,44.44444444,22.22222222,33.33333333
2022-04-09,4,2,3,9,44.44444444,22.22222222,33.33333333
2022-04-10,4,1,4,9,44.44444444,11.11111111,44.44444444
2022-04-11,2,5,1,8,25,62.5,12.5
2022-04-12,2,2,4,8,25,25,50
2022-04-13,1,2,7,10,10,20,70
2022-04-14,3,2,5,10,30,20,50
2022-04-15,4,3,3,10,40,30,30
2022-04-16,2,1,5,8,25,12.5,62.5
2022-04-17,4,0,3,7,57.14285714,0,42.85714286
2022-04-18,1,1,7,9,11.11111111,11.11111111,77.77777778
2022-04-19,4,3,2,9,44.44444444,33.33333333,22.22222222
2022-04-20,3,3,4,10,30,30,40
2022-04-21,4,1,5,10,40,10,50
2022-04-22,5,2,3,10,50,20,30
2022-04-23,4,0,3,7,57.14285714,0,42.85714286
2022-04-24,3,1,2,6,50,16.66666667,33.33333333
2022-04-25,2,3,3,8,25,37.5,37.5
2022-04-26,4,2,3,9,44.44444444,22.22222222,33.33333333
2022-04-27,3,2,5,10,30,20,50
2022-04-28,2,3,5,10,20,30,50
2022-04-29,5,1,1,7,71.42857143,14.28571429,14.28571429
2022-04-30,1,1,7,9,11.11111111,11.11111111,77.77777778
2022-05-01,4,0,4,8,50,0,50
2022-05-02,5,2,3,10,50,20,30
2022-05-03,0,5,5,10,0,50,50
2022-05-04,1,0,6,7,14.28571429,0,85.71428571
2022-05-05,5,2,2,9,55.55555556,22.22222222,22.22222222
2022-05-06,3,2,5,10,30,20,50
2022-05-07,4,2,3,9,44.44444444,22.22222222,33.33333333
2022-05-08,3,3,3,9,33.33333333,33.33333333,33.33333333
2022-05-09,1,3,4,8,12.5,37.5,50
2022-05-10,3,3,3,9,33.33333333,33.33333333,33.33333333
2022-05-11,3,4,3,10,30,40,30
2022-05-12,3,2,5,10,30,20,50
2022-05-13,3,2,5,10,30,20,50
2022-05-14,4,0,6,10,40,0,60
2022-05-15,2,1,6,9,22.22222222,11.11111111,66.66666667
2022-05-16,2,3,4,9,22.22222222,33.33333333,44.44444444
2022-05-17,3,2,5,10,30,20,50
2022-05-18,1,4,3,8,12.5,50,37.5
2022-05-19,3,3,3,9,33.33333333,33.33333333,33.33333333
2022-05-20,1,2,6,9,11.11111111,22.22222222,66.66666667
2022-05-21,1,1,5,7,14.28571429,14.28571429,71.42857143
2022-05-22,2,1,4,7,28.57142857,14.28571429,57.14285714
2022-05-23,4,1,5,10,40,10,50
2022-05-24,2,4,4,10,20,40,40
2022-05-25,3,1,4,8,37.5,12.5,50
2022-05-26,3,2,4,9,33.33333333,22.22222222,44.44444444
2022-05-27,5,0,5,10,50,0,50
2022-05-28,0,2,4,6,0,33.33333333,66.66666667
2022-05-29,0,2,1,3,0,66.66666667,33.33333333
2022-05-30,5,1,3,9,55.55555556,11.11111111,33.33333333
2022-05-31,4,4,2,10,40,40,20
2022-06-01,4,3,2,9,44.44444444,33.33333333,22.22222222
2022-06-02,4,1,5,10,40,10,50
2022-06-03,5,2,2,9,55.55555556,22.22222222,22.22222222
2022-06-04,2,2,1,5,40,40,20
2022-06-05,4,1,2,7,57.14285714,14.28571429,28.57142857
2022-06-06,1,2,7,10,10,20,70
2022-06-07,2,3,4,9,22.22222222,33.33333333,44.44444444
2022-06-08,3,0,5,8,37.5,0,62.5
2022-06-09,1,2,6,9,11.11111111,22.22222222,66.66666667
2022-06-10,2,3,5,10,20,30,50
2022-06-11,1,2,6,9,11.11111111,22.22222222,66.66666667
2022-06-12,3,3,4,10,30,30,40
2022-06-13,3,4,3,10,30,40,30
2022-06-14,1,2,5,8,12.5,25,62.5
2022-06-15,3,3,4,10,30,30,40
2022-06-16,1,4,3,8,12.5,50,37.5
2022-06-17,2,4,4,10,20,40,40
2022-06-18,1,4,4,9,11.11111111,44.44444444,44.44444444
2022-06-19,2,2,6,10,20,20,60
2022-06-20,2,3,3,8,25,37.5,37.5
2022-06-21,4,4,2,10,40,40,20
2022-06-22,1,1,8,10,10,10,80
2022-06-23,2,2,6,10,20,20,60
2022-06-24,2,2,4,8,25,25,50
2022-06-25,2,4,4,10,20,40,40
2022-06-26,4,3,2,9,44.44444444,33.33333333,22.22222222
2022-06-27,3,2,5,10,30,20,50
2022-06-28,2,2,6,10,20,20,60
2022-06-29,2,3,5,10,20,30,50
2022-06-30,0,5,3,8,0,62.5,37.5
2022-07-01,1,3,5,9,11.11111111,33.33333333,55.55555556
2022-07-02,3,1,5,9,33.33333333,11.11111111,55.55555556
2022-07-03,1,2,5,8,12.5,25,62.5
2022-07-04,2,3,4,9,22.22222222,33.33333333,44.44444444
2022-07-05,4,2,4,10,40,20,40
2022-07-06,3,0,7,10,30,0,70
2022-07-07,2,2,5,9,22.22222222,22.22222222,55.55555556
2022-07-08,1,4,5,10,10,40,50
2022-07-09,3,1,4,8,37.5,12.5,50
2022-07-10,3,4,1,8,37.5,50,12.5
2022-07-11,2,2,6,10,20,20,60
2022-07-12,2,2,5,9,22.22222222,22.22222222,55.55555556
2022-07-13,1,3,6,10,10,30,60
2022-07-14,1,2,6,9,11.11111111,22.22222222,66.66666667
2022-07-15,2,2,4,8,25,25,50
2022-07-16,1,3,6,10,10,30,60
2022-07-17,3,0,6,9,33.33333333,0,66.66666667
2022-07-18,4,0,6,10,40,0,60
2022-07-19,4,2,4,10,40,20,40
2022-07-20,5,0,4,9,55.55555556,0,44.44444444
2022-07-21,2,4,4,10,20,40,40
2022-07-22,2,2,5,9,22.22222222,22.22222222,55.55555556
2022-07-23,2,0,4,6,33.33333333,0,66.66666667
2022-07-24,4,3,3,10,40,30,30
2022-07-25,2,3,4,9,22.22222222,33.33333333,44.44444444
2022-07-26,4,1,4,9,44.44444444,11.11111111,44.44444444
2022-07-27,2,0,6,8,25,0,75
2022-07-28,4,1,5,10,40,10,50
2022-07-29,6,0,3,9,66.66666667,0,33.33333333
2022-07-30,3,2,3,8,37.5,25,37.5
2022-07-31,2,2,6,10,20,20,60
2022-08-01,2,1,6,9,22.22222222,11.11111111,66.66666667
2022-08-02,1,1,7,9,11.11111111,11.11111111,77.77777778
2022-08-03,2,3,4,9,22.22222222,33.33333333,44.44444444
2022-08-04,3,3,4,10,30,30,40
2022-08-05,0,1,7,8,0,12.5,87.5
2022-08-06,5,0,3,8,62.5,0,37.5
2022-08-07,3,0,6,9,33.33333333,0,66.66666667
2022-08-08,2,1,5,8,25,12.5,62.5
2022-08-09,3,2,4,9,33.33333333,22.22222222,44.44444444
2022-08-10,4,0,5,9,44.44444444,0,55.55555556
2022-08-11,4,0,5,9,44.44444444,0,55.55555556
2022-08-12,3,1,5,9,33.33333333,11.11111111,55.55555556
2022-08-13,0,0,8,8,0,0,100
2022-08-14,5,1,4,10,50,10,40
2022-08-15,3,5,2,10,30,50,20
2022-08-16,4,2,3,9,44.44444444,22.22222222,33.33333333
2022-08-17,1,2,6,9,11.11111111,22.22222222,66.66666667
2022-08-18,3,5,2,10,30,50,20
2022-08-19,1,2,7,10,10,20,70
2022-08-20,4,1,3,8,50,12.5,37.5
2022-08-21,1,3,3,7,14.28571429,42.85714286,42.85714286
2022-08-22,0,7,3,10,0,70,30
2022-08-23,1,6,2,9,11.11111111,66.66666667,22.22222222
2022-08-24,3,1,6,10,30,10,60
2022-08-25,1,3,6,10,10,30,60
2022-08-26,1,5,4,10,10,50,40
2022-08-27,2,2,5,9,22.22222222,22.22222222,55.55555556
2022-08-28,3,4,2,9,33.33333333,44.44444444,22.22222222
2022-08-29,1,3,6,10,10,30,60
2022-08-30,2,2,4,8,25,25,50
2022-08-31,3,4,2,9,33.33333333,44.44444444,22.22222222
2022-09-01,3,3,3,9,33.33333333,33.33333333,33.33333333
2022-09-02,2,1,5,8,25,12.5,62.5
2022-09-03,2,1,5,8,25,12.5,62.5
2022-09-04,3,4,3,10,30,40,30
2022-09-05,1,2,6,9,11.11111111,22.22222222,66.66666667
2022-09-06,2,2,5,9,22.22222222,22.22222222,55.55555556
2022-09-07,3,1,5,9,33.33333333,11.11111111,55.55555556
2022-09-08,1,3,6,10,10,30,60
2022-09-09,1,1,6,8,12.5,12.5,75
2022-09-10,2,1,7,10,20,10,70
2022-09-11,5,1,2,8,62.5,12.5,25
2022-09-12,1,0,9,10,10,0,90
2022-09-13,3,1,5,9,33.33333333,11.11111111,55.55555556
2022-09-14,3,4,3,10,30,40,30
2022-09-15,2,3,4,9,22.22222222,33.33333333,44.44444444
2022-09-16,4,4,2,10,40,40,20
2022-09-17,1,2,7,10,10,20,70
2022-09-18,2,0,8,10,20,0,80
2022-09-19,0,3,7,10,0,30,70
2022-09-20,2,4,3,9,22.22222222,44.44444444,33.33333333
2022-09-21,4,3,2,9,44.44444444,33.33333333,22.22222222
2022-09-22,3,2,4,9,33.33333333,22.22222222,44.44444444
2022-09-23,4,0,4,8,50,0,50
2022-09-24,2,2,3,7,28.57142857,28.57142857,42.85714286
2022-09-25,4,1,4,9,44.44444444,11.11111111,44.44444444
2022-09-26,2,2,6,10,20,20,60
2022-09-27,5,4,1,10,50,40,10
2022-09-28,5,2,3,10,50,20,30
2022-09-29,2,6,2,10,20,60,20
2022-09-30,4,0,6,10,40,0,60
2022-10-01,1,3,4,8,12.5,37.5,50
2022-10-02,3,2,5,10,30,20,50
2022-10-03,2,1,5,8,25,12.5,62.5
2022-10-04,3,1,5,9,33.33333333,11.11111111,55.55555556
2022-10-05,4,1,5,10,40,10,50
2022-10-06,3,1,3,7,42.85714286,14.28571429,42.85714286
2022-10-07,3,3,4,10,30,30,40
2022-10-08,2,2,5,9,22.22222222,22.22222222,55.55555556
2022-10-09,3,1,4,8,37.5,12.5,50
2022-10-10,2,1,7,10,20,10,70
2022-10-11,2,1,7,10,20,10,70
2022-10-12,4,2,4,10,40,20,40
2022-10-13,3,5,2,10,30,50,20
2022-10-14,4,2,3,9,44.44444444,22.22222222,33.33333333
2022-10-15,0,3,5,8,0,37.5,62.5
2022-10-16,4,2,4,10,40,20,40
2022-10-17,2,3,4,9,22.22222222,33.33333333,44.44444444
2022-10-18,3,3,4,10,30,30,40
2022-10-19,4,0,5,9,44.44444444,0,55.55555556
2022-10-20,3,2,4,9,33.33333333,22.22222222,44.44444444
2022-10-21,2,3,5,10,20,30,50
2022-10-22,1,1,7,9,11.11111111,11.11111111,77.77777778
2022-10-23,4,3,3,10,40,30,30
2022-10-24,0,6,3,9,0,66.66666667,33.33333333
2022-10-25,3,2,5,10,30,20,50
2022-10-26,1,1,7,9,11.11111111,11.11111111,77.77777778
2022-10-27,2,1,7,10,20,10,70
2022-10-28,1,4,4,9,11.11111111,44.44444444,44.44444444
2022-10-29,2,2,3,7,28.57142857,28.57142857,42.85714286
2022-10-30,2,2,3,7,28.57142857,28.57142857,42.85714286
2022-10-31,3,1,6,10,30,10,60
2022-11-01,2,0,8,10,20,0,80
2022-11-02,4,0,6,10,40,0,60
2022-11-03,3,3,4,10,30,30,40
2022-11-04,5,1,3,9,55.55555556,11.11111111,33.33333333
2022-11-05,1,2,4,7,14.28571429,28.57142857,57.14285714
2022-11-06,3,0,6,9,33.33333333,0,66.66666667
2022-11-07,2,3,4,9,22.22222222,33.33333333,44.44444444
2022-11-08,1,3,6,10,10,30,60
2022-11-09,1,4,5,10,10,40,50
2022-11-10,2,2,5,9,22.22222222,22.22222222,55.55555556
2022-11-11,2,3,4,9,22.22222222,33.33333333,44.44444444
2022-11-12,1,5,3,9,11.11111111,55.55555556,33.33333333
2022-11-13,0,5,4,9,0,55.55555556,44.44444444
2022-11-14,1,2,6,9,11.11111111,22.22222222,66.66666667
2022-11-15,1,2,6,9,11.11111111,22.22222222,66.66666667
2022-11-16,4,1,4,9,44.44444444,11.11111111,44.44444444
2022-11-17,5,2,2,9,55.55555556,22.22222222,22.22222222
2022-11-18,3,2,5,10,30,20,50
2022-11-19,1,4,2,7,14.28571429,57.14285714,28.57142857
2022-11-20,1,4,4,9,11.11111111,44.44444444,44.44444444
2022-11-21,0,3,7,10,0,30,70
2022-11-22,1,5,3,9,11.11111111,55.55555556,33.33333333
2022-11-23,1,4,4,9,11.11111111,44.44444444,44.44444444
2022-11-24,2,1,6,9,22.22222222,11.11111111,66.66666667
2022-11-25,0,2,5,7,0,28.57142857,71.42857143
2022-11-26,3,0,6,9,33.33333333,0,66.66666667
2022-11-27,1,3,1,5,20,60,20
2022-11-28,1,3,6,10,10,30,60
2022-11-29,1,4,4,9,11.11111111,44.44444444,44.44444444
2022-11-30,3,4,3,10,30,40,30
2022-12-01,3,3,3,9,33.33333333,33.33333333,33.33333333
2022-12-02,1,4,4,9,11.11111111,44.44444444,44.44444444
2022-12-03,1,1,7,9,11.11111111,11.11111111,77.77777778
2022-12-04,3,1,6,10,30,10,60
2022-12-05,4,1,5,10,40,10,50
2022-12-06,3,1,2,6,50,16.66666667,33.33333333
2022-12-07,3,1,4,8,37.5,12.5,50
2022-12-08,0,5,5,10,0,50,50
2022-12-09,1,1,5,7,14.28571429,14.28571429,71.42857143
2022-12-10,4,4,1,9,44.44444444,44.44444444,11.11111111
2022-12-11,6,2,2,10,60,20,20
2022-12-12,1,1,6,8,12.5,12.5,75
2022-12-13,2,1,6,9,22.22222222,11.11111111,66.66666667
2022-12-14,4,2,4,10,40,20,40
2022-12-15,3,2,5,10,30,20,50
2022-12-16,0,6,4,10,0,60,40
2022-12-17,3,2,4,9,33.33333333,22.22222222,44.44444444
2022-12-18,4,3,3,10,40,30,30
2022-12-19,3,2,2,7,42.85714286,28.57142857,28.57142857
2022-12-20,4,0,6,10,40,0,60
2022-12-21,4,0,5,9,44.44444444,0,55.55555556
2022-12-22,3,4,2,9,33.33333333,44.44444444,22.22222222
2022-12-23,2,2,6,10,20,20,60
2022-12-24,1,3,5,9,11.11111111,33.33333333,55.55555556
2022-12-25,5,1,3,9,55.55555556,11.11111111,33.33333333
2022-12-26,7,0,3,10,70,0,30
2022-12-27,3,4,3,10,30,40,30
2022-12-28,2,1,7,10,20,10,70
2022-12-29,4,5,1,10,40,50,10
2022-12-30,3,1,4,8,37.5,12.5,50
2022-12-31,3,2,5,10,30,20,50
2023-01-01,1,2,6,9,11.11111111,22.22222222,66.66666667
2023-01-02,4,1,4,9,44.44444444,11.11111111,44.44444444
2023-01-03,4,3,3,10,40,30,30
2023-01-04,2,0,8,10,20,0,80
2023-01-05,0,1,7,8,0,12.5,87.5
2023-01-06,5,2,2,9,55.55555556,22.22222222,22.22222222
2023-01-07,1,3,2,6,16.66666667,50,33.33333333
2023-01-08,3,2,4,9,33.33333333,22.22222222,44.44444444
2023-01-09,2,1,6,9,22.22222222,11.11111111,66.66666667
2023-01-10,4,0,3,7,57.14285714,0,42.85714286
2023-01-11,3,0,7,10,30,0,70
2023-01-12,3,2,4,9,33.33333333,22.22222222,44.44444444
2023-01-13,3,3,3,9,33.33333333,33.33333333,33.33333333
2023-01-14,4,1,3,8,50,12.5,37.5
2023-01-15,1,2,7,10,10,20,70
2023-01-16,4,2,2,8,50,25,25
2023-01-17,1,3,6,10,10,30,60
2023-01-18,5,1,4,10,50,10,40
2023-01-19,1,2,6,9,11.11111111,22.22222222,66.66666667
2023-01-20,5,2,3,10,50,20,30
2023-01-21,2,2,6,10,20,20,60
2023-01-22,4,3,2,9,44.44444444,33.33333333,22.22222222
2023-01-23,4,0,4,8,50,0,50
2023-01-24,0,4,4,8,0,50,50
2023-01-25,3,3,4,10,30,30,40
2023-01-26,2,3,4,9,22.22222222,33.33333333,44.44444444
2023-01-27,3,2,4,9,33.33333333,22.22222222,44.44444444
2023-01-28,2,2,5,9,22.22222222,22.22222222,55.55555556
2023-01-29,4,0,6,10,40,0,60
2023-01-30,2,2,5,9,22.22222222,22.22222222,55.55555556
2023-01-31,1,2,6,9,11.11111111,22.22222222,66.66666667
2023-02-01,5,0,5,10,50,0,50
2023-02-02,5,2,3,10,50,20,30
2023-02-03,3,0,5,8,37.5,0,62.5
2023-02-04,1,2,7,10,10,20,70
2023-02-05,4,2,3,9,44.44444444,22.22222222,33.33333333
2023-02-06,2,2,5,9,22.22222222,22.22222222,55.55555556
2023-02-07,3,2,4,9,33.33333333,22.22222222,44.44444444
2023-02-08,4,1,3,8,50,12.5,37.5
2023-02-09,3,3,4,10,30,30,40
2023-02-10,3,2,4,9,33.33333333,22.22222222,44.44444444
2023-02-11,3,3,1,7,42.85714286,42.85714286,14.28571429
2023-02-12,4,4,0,8,50,50,0
2023-02-13,1,6,3,10,10,60,30
2023-02-14,0,4,5,9,0,44.44444444,55.55555556
2023-02-15,5,0,4,9,55.55555556,0,44.44444444
2023-02-16,4,1,4,9,44.44444444,11.11111111,44.44444444
2023-02-17,2,1,5,8,25,12.5,62.5
2023-02-18,4,0,5,9,44.44444444,0,55.55555556
2023-02-19,2,2,6,10,20,20,60
2023-02-20,4,4,2,10,40,40,20
2023-02-21,4,0,4,8,50,0,50
2023-02-22,1,2,5,8,12.5,25,62.5
2023-02-23,5,2,3,10,50,20,30
2023-02-24,3,1,6,10,30,10,60
2023-12-11,0,0,4,4,0,0,100
2023-12-12,0,0,1,1,0,0,100
2023-12-13,2,2,1,5,40,40,20
2023-12-14,1,1,0,2,50,50,0
2023-12-15,2,0,0,2,100,0,0
2023-12-17,1,0,1,2,50,0,50
2023-12-19,2,0,0,2,100,0,0
2023-12-20,2,0,1,3,66.66666667,0,33.33333333
2023-12-21,2,0,0,2,100,0,0
2023-12-24,1,0,0,1,100,0,0
2023-12-25,1,0,1,2,50,0,50
2023-12-26,0,0,2,2,0,0,100
2023-12-27,1,2,0,3,33.33333333,66.66666667,0
2023-12-28,1,0,3,4,25,0,75
2023-12-29,1,0,1,2,50,0,50
2023-12-30,2,0,1,3,66.66666667,0,33.33333333
2023-12-31,2,0,1,3,66.66666667,0,33.33333333
2024-01-02,2,1,1,4,50,25,25
2024-01-03,6,1,2,9,66.66666667,11.11111111,22.22222222
2024-01-04,0,2,2,4,0,50,50
2024-01-05,0,0,2,2,0,0,100
2024-01-06,4,1,1,6,66.66666667,16.66666667,16.66666667
2024-01-08,1,1,1,3,33.33333333,33.33333333,33.33333333
2024-01-09,1,4,4,9,11.11111111,44.44444444,44.44444444
2024-01-10,7,6,10,23,30.43478261,26.08695652,43.47826087
2024-01-11,10,6,5,21,47.61904762,28.57142857,23.80952381
2024-01-12,5,4,6,15,33.33333333,26.66666667,40
2024-01-13,4,2,1,7,57.14285714,28.57142857,14.28571429
2024-01-14,0,1,1,2,0,50,50
2024-01-15,2,1,0,3,66.66666667,33.33333333,0
2024-01-16,2,0,3,5,40,0,60
2024-01-18,1,1,2,4,25,25,50
2024-01-19,3,1,6,10,30,10,60
2024-01-20,0,0,2,2,0,0,100
2024-01-21,4,1,0,5,80,20,0
2024-01-22,1,2,3,6,16.66666667,33.33333333,50
2024-01-23,0,0,3,3,0,0,100
2024-01-24,3,0,5,8,37.5,0,62.5
2024-01-25,0,0,4,4,0,0,100
2024-01-26,2,0,2,4,50,0,50
2024-01-27,0,0,1,1,0,0,100
2024-01-28,1,0,0,1,100,0,0
2024-01-29,1,3,1,5,20,60,20
2024-01-30,2,2,1,5,40,40,20
2024-01-31,3,1,2,6,50,16.66666667,33.33333333
2024-02-01,3,2,3,8,37.5,25,37.5
2024-02-02,2,2,3,7,28.57142857,28.57142857,42.85714286
2024-02-03,1,3,1,5,20,60,20
2024-02-04,1,3,2,6,16.66666667,50,33.33333333
2024-02-05,4,2,6,12,33.33333333,16.66666667,50
2024-02-06,2,5,5,12,16.66666667,41.66666667,41.66666667
2024-02-07,3,2,0,5,60,40,0
2024-02-08,0,1,0,1,0,100,0
2024-02-09,2,3,2,7,28.57142857,42.85714286,28.57142857
2024-02-10,0,1,2,3,0,33.33333333,66.66666667
2024-02-11,2,1,1,4,50,25,25
2024-02-12,2,1,4,7,28.57142857,14.28571429,57.14285714
2024-02-13,3,4,3,10,30,40,30
2024-02-14,1,0,3,4,25,0,75
2024-02-15,0,0,1,1,0,0,100
2024-02-17,1,0,1,2,50,0,50
2024-02-18,0,0,1,1,0,0,100
2024-02-19,4,0,0,4,100,0,0
2024-02-20,0,2,1,3,0,66.66666667,33.33333333
2024-02-21,3,1,1,5,60,20,20
2024-02-22,1,0,1,2,50,0,50
2024-02-23,0,1,5,6,0,16.66666667,83.33333333
2024-02-26,0,0,3,3,0,0,100
2024-02-27,4,0,4,8,50,0,50
2024-02-28,6,2,7,15,40,13.33333333,46.66666667
2024-02-29,5,2,5,12,41.66666667,16.66666667,41.66666667
2024-03-01,1,0,1,2,50,0,50
2024-03-02,0,0,1,1,0,0,100
2024-03-04,6,1,6,13,46.15384615,7.692307692,46.15384615
2024-03-05,7,5,12,24,29.16666667,20.83333333,50
2024-03-06,5,7,11,23,21.73913043,30.43478261,47.82608696
2024-03-07,3,0,1,4,75,0,25
2024-03-08,2,0,2,4,50,0,50
2024-03-09,5,0,3,8,62.5,0,37.5
2024-03-10,1,1,1,3,33.33333333,33.33333333,33.33333333
2024-03-11,7,7,9,23,30.43478261,30.43478261,39.13043478
2024-03-12,14,3,6,23,60.86956522,13.04347826,26.08695652
2024-03-13,1,1,0,2,50,50,0
2024-03-14,2,1,6,9,22.22222222,11.11111111,66.66666667
2024-03-15,1,4,5,10,10,40,50
2024-03-16,4,4,2,10,40,40,20
2024-03-17,0,0,1,1,0,0,100
2024-03-18,1,0,2,3,33.33333333,0,66.66666667
2024-03-19,1,1,2,4,25,25,50
2024-03-20,7,1,3,11,63.63636364,9.090909091,27.27272727
2024-03-21,2,3,6,11,18.18181818,27.27272727,54.54545455
2024-03-22,1,1,2,4,25,25,50
2024-03-23,2,1,3,6,33.33333333,16.66666667,50
2024-03-24,0,1,0,1,0,100,0
2024-03-25,1,1,5,7,14.28571429,14.28571429,71.42857143
2024-03-26,1,3,1,5,20,60,20
2024-03-27,6,1,2,9,66.66666667,11.11111111,22.22222222
2024-03-28,4,10,5,19,21.05263158,52.63157895,26.31578947
2024-03-29,1,9,1,11,9.090909091,81.81818182,9.090909091
2024-03-30,1,2,1,4,25,50,25
2024-03-31,2,0,1,3,66.66666667,0,33.33333333
2024-04-01,1,0,1,2,50,0,50
2024-04-02,0,0,1,1,0,0,100
2024-04-03,1,1,1,3,33.33333333,33.33333333,33.33333333
2024-04-04,1,0,2,3,33.33333333,0,66.66666667
2024-04-05,1,1,0,2,50,50,0
2024-04-06,0,0,2,2,0,0,100
2024-04-08,4,1,3,8,50,12.5,37.5
2024-04-09,0,1,2,3,0,33.33333333,66.66666667
2024-04-10,1,0,1,2,50,0,50
2024-04-11,0,1,1,2,0,50,50
2024-04-12,2,3,4,9,22.22222222,33.33333333,44.44444444
2024-04-13,3,2,1,6,50,33.33333333,16.66666667
2024-04-15,2,3,2,7,28.57142857,42.85714286,28.57142857
2024-04-16,2,0,0,2,100,0,0
2024-04-17,1,0,4,5,20,0,80
2024-04-18,0,0,2,2,0,0,100
2024-04-19,6,0,6,12,50,0,50
2024-04-20,0,0,1,1,0,0,100
2024-04-21,0,1,1,2,0,50,50
2024-04-22,2,0,1,3,66.66666667,0,33.33333333
2024-04-23,1,0,0,1,100,0,0
2024-04-24,2,0,0,2,100,0,0
2024-04-25,0,2,3,5,0,40,60
2024-04-26,0,0,3,3,0,0,100
2024-04-27,0,1,0,1,0,100,0
2024-04-28,1,0,0,1,100,0,0
2024-04-29,2,2,4,8,25,25,50
2024-04-30,1,2,4,7,14.28571429,28.57142857,57.14285714
2024-05-01,2,3,2,7,28.57142857,42.85714286,28.57142857
2024-05-02,1,0,2,3,33.33333333,0,66.66666667
2024-05-03,0,0,2,2,0,0,100
2024-05-05,1,0,0,1,100,0,0
2024-05-06,1,0,2,3,33.33333333,0,66.66666667
2024-05-07,1,1,1,3,33.33333333,33.33333333,33.33333333
2024-05-08,4,5,2,11,36.36363636,45.45454545,18.18181818
2024-05-09,1,5,5,11,9.090909091,45.45454545,45.45454545
2024-05-10,0,0,3,3,0,0,100
2024-05-11,1,0,2,3,33.33333333,0,66.66666667
2024-05-13,0,1,1,2,0,50,50
2024-05-14,0,0,1,1,0,0,100
2024-05-15,0,0,2,2,0,0,100
2024-05-16,2,0,0,2,100,0,0
2024-05-20,1,0,2,3,33.33333333,0,66.66666667
2024-05-21,3,2,4,9,33.33333333,22.22222222,44.44444444
2024-05-22,2,0,1,3,66.66666667,0,33.33333333
2024-05-23,1,1,1,3,33.33333333,33.33333333,33.33333333
2024-05-24,2,5,1,8,25,62.5,12.5
2024-05-25,0,3,2,5,0,60,40
2024-05-26,0,2,1,3,0,66.66666667,33.33333333
2024-05-27,0,0,1,1,0,0,100
2024-05-28,2,1,0,3,66.66666667,33.33333333,0
2024-05-29,3,2,0,5,60,40,0
2024-05-30,0,2,0,2,0,100,0
2024-06-02,1,0,1,2,50,0,50
2024-06-03,1,0,1,2,50,0,50
2024-06-04,0,1,0,1,0,100,0
2024-06-05,2,0,0,2,100,0,0
2024-06-06,1,0,0,1,100,0,0
2024-06-07,1,0,0,1,100,0,0
